,N,Z,A,EL,avEbind,nome
0,0,1,1,H,0.0,h1
1,1,1,2,H,1.1122830000000001,h2
2,2,1,3,H,2.827266,h3
3,1,2,3,He,2.572681,he3
5,3,1,4,H,1.4003510000000001,h4
6,2,2,4,He,7.073915,he4
7,1,3,4,Li,1.153761,li4
8,4,1,5,H,1.33636,h5
9,3,2,5,He,5.481132,he5
10,2,3,5,Li,5.266132,li5
12,5,1,6,H,0.9636330000000001,h6
13,4,2,6,He,4.878017,he6
14,3,3,6,Li,5.332345,li6
15,2,4,6,Be,4.487261999999999,be6
18,5,2,7,He,4.11907,he7
19,4,3,7,Li,5.606291000000001,li7
20,3,4,7,Be,5.3713999999999995,be7
21,2,5,7,B,3.5313059999999994,b7
22,6,2,8,He,3.9259749999999998,he8
23,5,3,8,Li,5.159582,li8
24,4,4,8,Be,7.062435000000001,be8
25,3,5,8,B,4.717164,b8
26,2,6,8,C,3.0978000000000003,c8
27,7,2,9,He,3.348637,he9
28,6,3,9,Li,5.037839,li9
29,5,4,9,Be,6.462758000000001,be9
30,4,5,9,B,6.25716,b9
31,3,6,9,C,4.337476,c9
32,8,2,10,He,3.0339270000000003,he10
33,7,3,10,Li,4.531555,li10
34,6,4,10,Be,6.497710999999999,be10
35,5,5,10,B,6.475071,b10
36,4,6,10,C,6.032041,c10
37,3,7,10,N,3.6436599999999997,n10
38,8,3,11,Li,4.149104,li11
39,7,4,11,Be,5.952821999999999,be11
40,6,5,11,B,6.9277109999999995,b11
41,5,6,11,C,6.6763699999999995,c11
42,4,7,11,N,5.364045,n11
44,8,4,12,Be,5.720826,be12
45,7,5,12,B,6.631264,b12
46,6,6,12,C,7.680144,c12
47,5,7,12,N,6.170108,n12
48,4,8,12,O,4.87909,o12
49,9,4,13,Be,5.27307,be13
50,8,5,13,B,6.496401999999999,b13
51,7,6,13,C,7.469849,c13
52,6,7,13,N,7.238863,n13
53,5,8,13,O,5.811994,o13
54,10,4,14,Be,4.993897,be14
55,9,5,14,B,6.101645,b14
56,8,6,14,C,7.520319000000001,c14
57,7,7,14,N,7.475614,n14
58,6,8,14,O,7.052308000000001,o14
61,10,5,15,B,5.87905,b15
62,9,6,15,C,7.100169,c15
63,8,7,15,N,7.699459,n15
64,7,8,15,O,7.463691999999999,o15
65,6,9,15,F,6.483550999999999,f15
67,11,5,16,B,5.509228,b16
68,10,6,16,C,6.922054,c16
69,9,7,16,N,7.373812,n16
70,8,8,16,O,7.976206,o16
71,7,9,16,F,6.963731,f16
72,6,10,16,Ne,6.082571999999999,ne16
73,12,5,17,B,5.266461,b17
74,11,6,17,C,6.557616,c17
75,10,7,17,N,7.2861530000000005,n17
76,9,8,17,O,7.750731,o17
77,8,9,17,F,7.542328,f17
78,7,10,17,Ne,6.642825,ne17
80,12,6,18,C,6.425746999999999,c18
81,11,7,18,N,7.0384899999999995,n18
82,10,8,18,O,7.767024999999999,o18
83,9,9,18,F,7.6316049999999995,f18
84,8,10,18,Ne,7.341282,ne18
85,7,11,18,Na,6.249329,na18
87,13,6,19,C,6.117909000000001,c19
88,12,7,19,N,6.9482349999999995,n19
89,11,8,19,O,7.566389,o19
90,10,9,19,F,7.779015,f19
91,9,10,19,Ne,7.567375,ne19
92,8,11,19,Na,6.938021,na19
93,7,12,19,Mg,5.8382510000000005,mg19
94,14,6,20,C,5.9587330000000005,c20
95,13,7,20,N,6.709239999999999,n20
96,12,8,20,O,7.568505,o20
97,11,9,20,F,7.720130999999999,f20
98,10,10,20,Ne,8.03224,ne20
99,9,11,20,Na,7.298641,na20
100,8,12,20,Mg,6.723392,mg20
102,14,7,21,N,6.608099,n21
103,13,8,21,O,7.389332,o21
104,12,9,21,F,7.73829,f21
105,11,10,21,Ne,7.971713,ne21
106,10,11,21,Na,7.765524,na21
107,9,12,21,Mg,7.1047139999999995,mg21
110,15,7,22,N,6.366085,n22
111,14,8,22,O,7.364821,o22
112,13,9,22,F,7.624294,f22
113,12,10,22,Ne,8.080465,ne22
114,11,11,22,Na,7.915709,na22
115,10,12,22,Mg,7.662626,mg22
119,15,8,23,O,7.16385,o23
120,14,9,23,F,7.62041,f23
121,13,10,23,Ne,7.955255,ne23
122,12,11,23,Na,8.111493000000001,na23
123,11,12,23,Mg,7.9011260000000005,mg23
124,10,13,23,Al,7.334791999999999,al23
127,16,8,24,O,7.015935000000001,o24
128,15,9,24,F,7.462956999999999,f24
129,14,10,24,Ne,7.9933190000000005,ne24
130,13,11,24,Na,8.063496,na24
131,12,12,24,Mg,8.260709,mg24
132,11,13,24,Al,7.649919,al24
133,10,14,24,Si,7.166836999999999,si24
137,16,9,25,F,7.338764,f25
138,15,10,25,Ne,7.842701,ne25
139,14,11,25,Na,8.101397,na25
140,13,12,25,Mg,8.223504,mg25
141,12,13,25,Al,8.021144,al25
142,11,14,25,Si,7.48023,si25
145,17,9,26,F,7.0977440000000005,f26
146,16,10,26,Ne,7.753890999999999,ne26
147,15,11,26,Na,8.00426,na26
148,14,12,26,Mg,8.333872,mg26
149,13,13,26,Al,8.149771,al26
150,12,14,26,Si,7.924847,si26
154,18,9,27,F,6.8873180000000005,f27
155,17,10,27,Ne,7.519709,ne27
156,16,11,27,Na,7.956933000000001,na27
157,15,12,27,Mg,8.263853999999998,mg27
158,14,13,27,Al,8.331545,al27
159,13,14,27,Si,8.124334,si27
160,12,15,27,P,7.663236999999999,p27
164,18,10,28,Ne,7.390314999999999,ne28
165,17,11,28,Na,7.799296999999999,na28
166,16,12,28,Mg,8.272405999999998,mg28
167,15,13,28,Al,8.309886,al28
168,14,14,28,Si,8.447744,si28
169,13,15,28,P,7.907873,p28
170,12,16,28,S,7.47879,s28
173,19,10,29,Ne,7.178857,ne29
174,18,11,29,Na,7.6826680000000005,na29
175,17,12,29,Mg,8.113761,mg29
176,16,13,29,Al,8.348725,al29
177,15,14,29,Si,8.448634,si29
178,14,15,29,P,8.251228000000001,p29
179,13,16,29,S,7.748629,s29
182,20,10,30,Ne,7.040467,ne30
183,19,11,30,Na,7.505754,na30
184,18,12,30,Mg,8.055401,mg30
185,17,13,30,Al,8.261381,al30
186,16,14,30,Si,8.520653,si30
187,15,15,30,P,8.353496,p30
188,14,16,30,S,8.122817,s30
193,20,11,31,Na,7.385491999999999,na31
194,19,12,31,Mg,7.87226,mg31
195,18,13,31,Al,8.225610999999999,al31
196,17,14,31,Si,8.458290000000002,si31
197,16,15,31,P,8.481178,p31
198,15,16,31,S,8.281869,s31
199,14,17,31,Cl,7.870260999999999,cl31
202,21,11,32,Na,7.206621,na32
203,20,12,32,Mg,7.807774,mg32
204,19,13,32,Al,8.099175,al32
205,18,14,32,Si,8.481569,si32
206,17,15,32,P,8.464129999999999,p32
207,16,16,32,S,8.493134,s32
208,15,17,32,Cl,8.072251,cl32
209,14,18,32,Ar,7.700003000000001,ar32
212,22,11,33,Na,7.056314,na33
213,21,12,33,Mg,7.638522,mg33
214,20,13,33,Al,8.021586,al33
215,19,14,33,Si,8.360402,si33
216,18,15,33,P,8.513811,p33
217,17,16,33,S,8.497634,s33
218,16,17,33,Cl,8.304758,cl33
219,15,18,33,Ar,7.9289499999999995,ar33
223,22,12,34,Mg,7.536118,mg34
224,21,13,34,Al,7.858434,al34
225,20,14,34,Si,8.336138,si34
226,19,15,34,P,8.448449,p34
227,18,16,34,S,8.583501,s34
228,17,17,34,Cl,8.398961,cl34
229,16,18,34,Ar,8.19764,ar34
234,22,13,35,Al,7.784451,al35
235,21,14,35,Si,8.168673,si35
236,20,15,35,P,8.446247,p35
237,19,16,35,S,8.537855,s35
238,18,17,35,Cl,8.520278000000001,cl35
239,17,18,35,Ar,8.327465,ar35
240,16,19,35,K,7.965726,k35
244,23,13,36,Al,7.6281930000000004,al36
245,22,14,36,Si,8.113807,si36
246,21,15,36,P,8.307866,p36
247,20,16,36,S,8.575387,s36
248,19,17,36,Cl,8.521927,cl36
249,18,18,36,Ar,8.519909,ar36
250,17,19,36,K,8.142472,k36
251,16,20,36,Ca,7.815550999999999,ca36
255,24,13,37,Al,7.5276190000000005,al37
256,23,14,37,Si,7.953131999999999,si37
257,22,15,37,P,8.267505,p37
258,21,16,37,S,8.459934,s37
259,20,17,37,Cl,8.57028,cl37
260,19,18,37,Ar,8.527139000000002,ar37
261,18,19,37,K,8.339846999999999,k37
262,17,20,37,Ca,8.00415,ca37
265,25,13,38,Al,7.3812880000000005,al38
266,24,14,38,Si,7.890118,si38
267,23,15,38,P,8.15086,p38
268,22,16,38,S,8.448782,s38
269,21,17,38,Cl,8.50548,cl38
270,20,18,38,Ar,8.614273,ar38
271,19,19,38,K,8.438056999999999,k38
272,18,20,38,Ca,8.240062,ca38
276,26,13,39,Al,7.261909,al39
277,25,14,39,Si,7.741034000000001,si39
278,24,15,39,P,8.10051,p39
279,23,16,39,S,8.344258,s39
280,22,17,39,Cl,8.494402000000001,cl39
281,21,18,39,Ar,8.562593000000001,ar39
282,20,19,39,K,8.55702,k39
283,19,20,39,Ca,8.369457,ca39
284,18,21,39,Sc,8.013335999999999,sc39
288,26,14,40,Si,7.660819,si40
289,25,15,40,P,7.980608,p40
290,24,16,40,S,8.330043,s40
291,23,17,40,Cl,8.427764999999999,cl40
292,22,18,40,Ar,8.595259,ar40
293,21,19,40,K,8.538083,k40
294,20,20,40,Ca,8.551300999999999,ca40
295,19,21,40,Sc,8.173666,sc40
296,18,22,40,Ti,7.862283000000001,ti40
299,27,14,41,Si,7.47338,si41
300,26,15,41,P,7.913788,p41
301,25,16,41,S,8.229892,s41
302,24,17,41,Cl,8.412958,cl41
303,23,18,41,Ar,8.534370999999998,ar41
304,22,19,41,K,8.576061,k41
305,21,20,41,Ca,8.546703,ca41
306,20,21,41,Sc,8.369198,sc41
311,27,15,42,P,7.769554,p42
312,26,16,42,S,8.194173000000001,s42
313,25,17,42,Cl,8.347819,cl42
314,24,18,42,Ar,8.555613000000001,ar42
315,23,19,42,K,8.551245000000002,k42
316,22,20,42,Ca,8.616559,ca42
317,21,21,42,Sc,8.444935,sc42
318,20,22,42,Ti,8.259649,ti42
322,28,15,43,P,7.664314,p43
323,27,16,43,S,8.058473000000001,s43
324,26,17,43,Cl,8.324068,cl43
325,25,18,43,Ar,8.488237,ar43
326,24,19,43,K,8.576635,k43
327,23,20,43,Ca,8.600659,ca43
328,22,21,43,Sc,8.530821,sc43
329,21,22,43,Ti,8.352933,ti43
334,28,16,44,S,7.994013000000001,s44
335,27,17,44,Cl,8.228843000000001,cl44
336,26,18,44,Ar,8.493836,ar44
337,25,19,44,K,8.54734,k44
338,24,20,44,Ca,8.65817,ca44
339,23,21,44,Sc,8.557381,sc44
340,22,22,44,Ti,8.533518,ti44
341,21,23,44,V,8.210462999999999,v44
345,29,16,45,S,7.865430999999999,s45
346,28,17,45,Cl,8.183823,cl45
347,27,18,45,Ar,8.419947,ar45
348,26,19,45,K,8.554508,k45
349,25,20,45,Ca,8.630540000000002,ca45
350,24,21,45,Sc,8.61884,sc45
351,23,22,45,Ti,8.555631,ti45
352,22,23,45,V,8.379886999999998,v45
353,21,24,45,Cr,8.075515000000001,cr45
358,29,17,46,Cl,8.101934,cl46
359,28,18,46,Ar,8.411271000000001,ar46
360,27,19,46,K,8.518137,k46
361,26,20,46,Ca,8.668885,ca46
362,25,21,46,Sc,8.621921999999998,sc46
363,24,22,46,Ti,8.656356,ti46
364,23,23,46,V,8.486079,v46
365,22,24,46,Cr,8.303870000000002,cr46
370,29,18,47,Ar,8.322925999999999,ar47
371,28,19,47,K,8.514543999999999,k47
372,27,20,47,Ca,8.639256999999999,ca47
373,26,21,47,Sc,8.664995000000001,sc47
374,25,22,47,Ti,8.661121,ti47
375,24,23,47,V,8.582127,v47
376,23,24,47,Cr,8.407106,cr47
383,29,19,48,K,8.430886999999998,k48
384,28,20,48,Ca,8.666466999999999,ca48
385,27,21,48,Sc,8.656043,sc48
386,26,22,48,Ti,8.722903,ti48
387,25,23,48,V,8.623013,v48
388,24,24,48,Cr,8.572209999999998,cr48
389,23,25,48,Mn,8.27475,mn48
396,30,19,49,K,8.386719000000001,k49
397,29,20,49,Ca,8.594629999999999,ca49
398,28,21,49,Sc,8.686074000000001,sc49
399,27,22,49,Ti,8.711055,ti49
400,26,23,49,V,8.682806000000001,v49
401,25,24,49,Cr,8.613239,cr49
402,24,25,49,Mn,8.439825999999998,mn49
408,31,19,50,K,8.281068000000001,k50
409,30,20,50,Ca,8.549795,ca50
410,29,21,50,Sc,8.633469000000002,sc50
411,28,22,50,Ti,8.755618,ti50
412,27,23,50,V,8.695869,v50
413,26,24,50,Cr,8.700981,cr50
414,25,25,50,Mn,8.532680000000001,mn50
415,24,26,50,Fe,8.354008,fe50
421,31,20,51,Ca,8.467716000000001,ca51
422,30,21,51,Sc,8.59659,sc51
423,29,22,51,Ti,8.70889,ti51
424,28,23,51,V,8.742051,v51
425,27,24,51,Cr,8.711954,cr51
426,26,25,51,Mn,8.633723,mn51
427,25,26,51,Fe,8.461146999999999,fe51
432,32,20,52,Ca,8.39559,ca52
433,31,21,52,Sc,8.531457,sc52
434,30,22,52,Ti,8.691571,ti52
435,29,23,52,V,8.714535,v52
436,28,24,52,Cr,8.775943999999999,cr52
437,27,25,52,Mn,8.670294,mn52
438,26,26,52,Fe,8.609598,fe52
446,31,22,53,Ti,8.630132,ti53
447,30,23,53,V,8.710087999999999,v53
448,29,24,53,Cr,8.760155000000001,cr53
449,28,25,53,Mn,8.734133,mn53
450,27,26,53,Fe,8.648757,fe53
451,26,27,53,Co,8.477382,co53
456,33,21,54,Sc,8.400753,sc54
457,32,22,54,Ti,8.596924000000001,ti54
458,31,23,54,V,8.662002000000001,v54
459,30,24,54,Cr,8.777914,cr54
460,29,25,54,Mn,8.737923,mn54
461,28,26,54,Fe,8.736344,fe54
462,27,27,54,Co,8.569209,co54
463,26,28,54,Ni,8.391780999999998,ni54
468,34,21,55,Sc,8.310431999999999,sc55
469,33,22,55,Ti,8.516021,ti55
470,32,23,55,V,8.637816999999998,v55
471,31,24,55,Cr,8.731884,cr55
472,30,25,55,Mn,8.764988,mn55
473,29,26,55,Fe,8.746559999999999,fe55
474,28,27,55,Co,8.669575,co55
475,27,28,55,Ni,8.497315,ni55
480,34,22,56,Ti,8.459266,ti56
481,33,23,56,V,8.572854999999999,v56
482,32,24,56,Cr,8.723190999999998,cr56
483,31,25,56,Mn,8.738299999999999,mn56
484,30,26,56,Fe,8.790323,fe56
485,29,27,56,Co,8.694816999999999,co56
486,28,28,56,Ni,8.642709,ni56
492,35,22,57,Ti,8.357848,ti57
493,34,23,57,V,8.530873999999999,v57
494,33,24,57,Cr,8.663384,cr57
495,32,25,57,Mn,8.736723,mn57
496,31,26,57,Fe,8.770249,fe57
497,30,27,57,Co,8.741858,co57
498,29,28,57,Ni,8.670901,ni57
499,28,29,57,Cu,8.503274,cu57
504,35,23,58,V,8.45433,v58
505,34,24,58,Cr,8.641290000000001,cr58
506,33,25,58,Mn,8.69801,mn58
507,32,26,58,Fe,8.792221,fe58
508,31,27,58,Co,8.738947,co58
509,30,28,58,Ni,8.732040999999999,ni58
510,29,29,58,Cu,8.570869,cu58
511,28,30,58,Zn,8.395926,zn58
516,36,23,59,V,8.394581,v59
517,35,24,59,Cr,8.564795,cr59
518,34,25,59,Mn,8.680146,mn59
519,33,26,59,Fe,8.754743000000001,fe59
520,32,27,59,Co,8.768013000000002,co59
521,31,28,59,Ni,8.73657,ni59
522,30,29,59,Cu,8.641981,cu59
523,29,30,59,Zn,8.474539,zn59
528,37,23,60,V,8.314371999999999,v60
529,36,24,60,Cr,8.533443000000002,cr60
530,35,25,60,Mn,8.631637,mn60
531,34,26,60,Fe,8.755831,fe60
532,33,27,60,Co,8.746745,co60
533,32,28,60,Ni,8.780757,ni60
534,31,29,60,Cu,8.665584999999998,cu60
535,30,30,60,Zn,8.583273000000002,zn60
541,37,24,61,Cr,8.454995,cr61
542,36,25,61,Mn,8.595859,mn61
543,35,26,61,Fe,8.703781999999999,fe61
544,34,27,61,Co,8.756154,co61
545,33,28,61,Ni,8.765009,ni61
546,32,29,61,Cu,8.715506999999999,cu61
547,31,30,61,Zn,8.610253,zn61
548,30,31,61,Ga,8.445706,ga61
553,38,24,62,Cr,8.420321,cr62
554,37,25,62,Mn,8.530674000000001,mn62
555,36,26,62,Fe,8.693247999999999,fe62
556,35,27,62,Co,8.721448,co62
557,34,28,62,Ni,8.794549000000002,ni62
558,33,29,62,Cu,8.718249,cu62
559,32,30,62,Zn,8.679398,zn62
560,31,31,62,Ga,8.51886,ga62
566,38,25,63,Mn,8.496595,mn63
567,37,26,63,Fe,8.630124,fe63
568,36,27,63,Co,8.717619000000001,co63
569,35,28,63,Ni,8.763489,ni63
570,34,29,63,Cu,8.752134,cu63
571,33,30,63,Zn,8.686279,zn63
572,32,31,63,Ga,8.583926,ga63
577,39,25,64,Mn,8.431599,mn64
578,38,26,64,Fe,8.60928,fe64
579,37,27,64,Co,8.675525,co64
580,36,28,64,Ni,8.777466999999998,ni64
581,35,29,64,Cu,8.73907,cu64
582,34,30,64,Zn,8.735898,zn64
583,33,31,64,Ga,8.611654,ga64
584,32,32,64,Ge,8.529361,ge64
588,40,25,65,Mn,8.396148,mn65
589,39,26,65,Fe,8.541116,fe65
590,38,27,65,Co,8.656649,co65
591,37,28,65,Ni,8.736246,ni65
592,36,29,65,Cu,8.757095999999999,cu65
593,35,30,65,Zn,8.724259,zn65
594,34,31,65,Ga,8.662154000000001,ga65
595,33,32,65,Ge,8.554079,ge65
600,40,26,66,Fe,8.514234,fe66
601,39,27,66,Co,8.601438,co66
602,38,28,66,Ni,8.739507999999999,ni66
603,37,29,66,Cu,8.731472,cu66
604,36,30,66,Zn,8.759636,zn66
605,35,31,66,Ga,8.669373,ga66
606,34,32,66,Ge,8.625701,ge66
607,33,33,66,As,8.460482,as66
611,41,26,67,Fe,8.449695,fe67
612,40,27,67,Co,8.57785,co67
613,39,28,67,Ni,8.69575,ni67
614,38,29,67,Cu,8.737447,cu67
615,37,30,67,Zn,8.734154,zn67
616,36,31,67,Ga,8.707540000000002,ga67
617,35,32,67,Ge,8.632850000000001,ge67
618,34,33,67,As,8.531471999999999,as67
622,42,26,68,Fe,8.406422,fe68
623,41,27,68,Co,8.515833,co68
624,40,28,68,Ni,8.682466,ni68
625,39,29,68,Cu,8.701889999999999,cu68
626,38,30,68,Zn,8.755681999999998,zn68
627,37,31,68,Ga,8.70122,ga68
628,36,32,68,Ge,8.688151,ge68
629,35,33,68,As,8.557814,as68
630,34,34,68,Se,8.47742,se68
634,42,27,69,Co,8.489857,co69
635,41,28,69,Ni,8.623099,ni69
636,40,29,69,Cu,8.695203000000001,cu69
637,39,30,69,Zn,8.722731,zn69
638,38,31,69,Ga,8.724578000000001,ga69
639,37,32,69,Ge,8.680962,ge69
640,36,33,69,As,8.611450999999999,as69
641,35,34,69,Se,8.501777,se69
645,43,27,70,Co,8.421601,co70
646,42,28,70,Ni,8.603377,ni70
647,41,29,70,Cu,8.646861,cu70
648,40,30,70,Zn,8.729806,zn70
649,39,31,70,Ga,8.709279,ga70
650,38,32,70,Ge,8.721716999999998,ge70
651,37,33,70,As,8.621684000000002,as70
652,36,34,70,Se,8.577695,se70
656,44,27,71,Co,8.39174,co71
657,43,28,71,Ni,8.540304,ni71
658,42,29,71,Cu,8.635022,cu71
659,41,30,71,Zn,8.689014,zn71
660,40,31,71,Ga,8.71762,ga71
661,39,32,71,Ge,8.703325999999999,ge71
662,38,33,71,As,8.663949,as71
663,37,34,71,Se,8.585635,se71
664,36,35,71,Br,8.489362,br71
665,35,36,71,Kr,8.335526,kr71
669,44,28,72,Ni,8.516242,ni72
670,43,29,72,Cu,8.586525,cu72
671,42,30,72,Zn,8.691609,zn72
672,41,31,72,Ga,8.687104,ga72
673,40,32,72,Ge,8.731745,ge72
674,39,33,72,As,8.660378000000001,as72
675,38,34,72,Se,8.644853999999999,se72
676,37,35,72,Br,8.510665000000001,br72
677,36,36,72,Kr,8.429323,kr72
681,44,29,73,Cu,8.568556999999998,cu73
682,43,30,73,Zn,8.645837,zn73
683,42,31,73,Ga,8.693873,ga73
684,41,32,73,Ge,8.705049,ge73
685,40,33,73,As,8.689663000000001,as73
686,39,34,73,Se,8.641425,se73
687,38,35,73,Br,8.567849,br73
688,37,36,73,Kr,8.460184000000002,kr73
693,45,29,74,Cu,8.521562,cu74
694,44,30,74,Zn,8.642107,zn74
695,43,31,74,Ga,8.663165999999999,ga74
696,42,32,74,Ge,8.725200000000001,ge74
697,41,33,74,As,8.68,as74
698,40,34,74,Se,8.687708,se74
699,39,35,74,Br,8.583803,br74
700,38,36,74,Kr,8.533033999999999,kr74
701,37,37,74,Rb,8.381726,rb74
705,46,29,75,Cu,8.490407,cu75
706,45,30,75,Zn,8.591299000000001,zn75
707,44,31,75,Ga,8.660808000000001,ga75
708,43,32,75,Ge,8.695602,ge75
709,42,33,75,As,8.70085,as75
710,41,34,75,Se,8.678906999999999,se75
711,40,35,75,Br,8.628075999999998,br75
712,39,36,75,Kr,8.553439000000001,kr75
713,38,37,75,Rb,8.448315000000001,rb75
714,37,38,75,Sr,8.296551,sr75
716,47,29,76,Cu,8.443527,cu76
717,46,30,76,Zn,8.580083,zn76
718,45,31,76,Ga,8.624526,ga76
719,44,32,76,Ge,8.705238000000001,ge76
720,43,33,76,As,8.682792,as76
721,42,34,76,Se,8.711478000000001,se76
722,41,35,76,Br,8.635883,br76
723,40,36,76,Kr,8.608815,kr76
724,39,37,76,Rb,8.486225000000001,rb76
725,38,38,76,Sr,8.393879,sr76
729,47,30,77,Zn,8.529135,zn77
730,46,31,77,Ga,8.613389999999999,ga77
731,45,32,77,Ge,8.671044,ge77
732,44,33,77,As,8.695981,as77
733,43,34,77,Se,8.694690999999999,se77
734,42,35,77,Br,8.666808000000001,br77
735,41,36,77,Kr,8.616836,kr77
736,40,37,77,Rb,8.537261,rb77
737,39,38,77,Sr,8.435926,sr77
741,48,30,78,Zn,8.505576,zn78
742,47,31,78,Ga,8.577135,ga78
743,46,32,78,Ge,8.671665,ge78
744,45,33,78,As,8.673881,as78
745,44,34,78,Se,8.717808000000002,se78
746,43,35,78,Br,8.661959999999999,br78
747,42,36,78,Kr,8.661256,kr78
748,41,37,78,Rb,8.558361,rb78
749,40,38,78,Sr,8.500096,sr78
754,48,31,79,Ga,8.555579999999999,ga79
755,47,32,79,Ge,8.634019,ge79
756,46,33,79,As,8.676622,as79
757,45,34,79,Se,8.695593,se79
758,44,35,79,Br,8.6876,br79
759,43,36,79,Kr,8.657118,kr79
760,42,37,79,Rb,8.601147,rb79
761,41,38,79,Sr,8.523815999999998,sr79
762,40,39,79,Y,8.423786,y79
765,50,30,80,Zn,8.425996999999999,zn80
766,49,31,80,Ga,8.507347,ga80
767,48,32,80,Ge,8.627318,ge80
768,47,33,80,As,8.65059,as80
769,46,34,80,Se,8.710818999999999,se80
770,45,35,80,Br,8.677659,br80
771,44,36,80,Kr,8.692917,kr80
772,43,37,80,Rb,8.611642,rb80
773,42,38,80,Sr,8.578555,sr80
774,41,39,80,Y,8.455145,y80
775,40,40,80,Zr,8.374107,zr80
777,50,31,81,Ga,8.487744000000001,ga81
778,49,32,81,Ge,8.580801,ge81
779,48,33,81,As,8.648056,as81
780,47,34,81,Se,8.686005,se81
781,46,35,81,Br,8.695917999999999,br81
782,45,36,81,Kr,8.682793,kr81
783,44,37,81,Rb,8.64549,rb81
784,43,38,81,Sr,8.587348,sr81
785,42,39,81,Y,8.509661,y81
786,41,40,81,Zr,8.407053,zr81
790,50,32,82,Ge,8.566304,ge82
791,49,33,82,As,8.61408,as82
792,48,34,82,Se,8.693198,se82
793,47,35,82,Br,8.682468,br82
794,46,36,82,Kr,8.710647,kr82
795,45,37,82,Rb,8.647431000000001,rb82
796,44,38,82,Sr,8.635698,sr82
797,43,39,82,Y,8.53084,y82
803,50,33,83,As,8.602199,as83
804,49,34,83,Se,8.658556999999998,se83
805,48,35,83,Br,8.693327,br83
806,47,36,83,Kr,8.695621,kr83
807,46,37,83,Rb,8.675269,rb83
808,45,38,83,Sr,8.638380999999999,sr83
809,44,39,83,Y,8.575113000000002,y83
810,43,40,83,Zr,8.494988000000001,zr83
811,42,41,83,Nb,8.395200999999998,nb83
816,50,34,84,Se,8.658841,se84
817,49,35,84,Br,8.671522,br84
818,48,36,84,Kr,8.717347,kr84
819,47,37,84,Rb,8.676117,rb84
820,46,38,84,Sr,8.677444,sr84
821,45,39,84,Y,8.590916,y84
828,51,34,85,Se,8.610476,se85
829,50,35,85,Br,8.674001,br85
830,49,36,85,Kr,8.698561999999999,kr85
831,48,37,85,Rb,8.697441,rb85
832,47,38,85,Sr,8.675709999999999,sr85
833,46,39,85,Y,8.628148000000001,y85
834,45,40,85,Zr,8.563732,zr85
835,44,41,85,Nb,8.48394,nb85
841,52,34,86,Se,8.582256,se86
842,51,35,86,Br,8.63245,br86
843,50,36,86,Kr,8.712027,kr86
844,49,37,86,Rb,8.696901,rb86
845,48,38,86,Sr,8.708461,sr86
846,47,39,86,Y,8.638434000000002,y86
847,46,40,86,Zr,8.612136999999999,zr86
848,45,41,86,Nb,8.510271999999999,nb86
849,44,42,86,Mo,8.439896000000001,mo86
853,53,34,87,Se,8.530882,se87
854,52,35,87,Br,8.60551,br87
855,51,36,87,Kr,8.675282,kr87
856,50,37,87,Rb,8.710983,rb87
857,49,38,87,Sr,8.705238999999999,sr87
858,48,39,87,Y,8.674848,y87
859,47,40,87,Zr,8.623665,zr87
860,46,41,87,Nb,8.555305,nb87
861,45,42,87,Mo,8.471735,mo87
866,54,34,88,Se,8.494935,se88
867,53,35,88,Br,8.563931,br88
868,52,36,88,Kr,8.656859,kr88
869,51,37,88,Rb,8.681115,rb88
870,50,38,88,Sr,8.732596,sr88
871,49,39,88,Y,8.682540000000001,y88
872,48,40,88,Zr,8.665968000000001,zr88
873,47,41,88,Nb,8.571282,nb88
874,46,42,88,Mo,8.524062,mo88
880,54,35,89,Br,8.534120000000001,br89
881,53,36,89,Kr,8.616959000000001,kr89
882,52,37,89,Rb,8.664190000000001,rb89
883,51,38,89,Sr,8.705924000000001,sr89
884,50,39,89,Y,8.713904000000001,y89
885,49,40,89,Zr,8.673283999999999,zr89
886,48,41,89,Nb,8.617094000000002,nb89
887,47,42,89,Mo,8.54486,mo89
893,55,35,90,Br,8.485069,br90
894,54,36,90,Kr,8.591377,kr90
895,53,37,90,Rb,8.631483,rb90
896,52,38,90,Sr,8.6959,sr90
897,51,39,90,Y,8.693271999999999,y90
898,50,40,90,Zr,8.70991,zr90
899,49,41,90,Nb,8.633318000000001,nb90
900,48,42,90,Mo,8.596969000000001,mo90
901,47,43,90,Tc,8.488714,tc90
906,56,35,91,Br,8.44633,br91
907,55,36,91,Kr,8.545447,kr91
908,54,37,91,Rb,8.607564,rb91
909,53,38,91,Sr,8.663802,sr91
910,52,39,91,Y,8.684871999999999,y91
911,51,40,91,Zr,8.693257,zr91
912,50,41,91,Nb,8.670836,nb91
913,49,42,91,Mo,8.613577,mo91
914,48,43,91,Tc,8.536628,tc91
920,57,35,92,Br,8.388687,br92
921,56,36,92,Kr,8.512844999999999,kr92
922,55,37,92,Rb,8.569417,rb92
923,54,38,92,Sr,8.648909999999999,sr92
924,53,39,92,Y,8.661554,y92
925,52,40,92,Zr,8.692622,zr92
926,51,41,92,Nb,8.662318,nb92
927,50,42,92,Mo,8.657691999999999,mo92
928,49,43,92,Tc,8.56364,tc92
934,57,36,93,Kr,8.456834,kr93
935,56,37,93,Rb,8.540895,rb93
936,55,38,93,Sr,8.612773,sr93
937,54,39,93,Y,8.648862,y93
938,53,40,93,Zr,8.671565999999999,zr93
939,52,41,93,Nb,8.664135,nb93
940,51,42,93,Mo,8.65137,mo93
941,50,43,93,Tc,8.608539,tc93
942,49,44,93,Ru,8.531986999999999,ru93
949,57,37,94,Rb,8.492663,rb94
950,56,38,94,Sr,8.593777,sr94
951,55,39,94,Y,8.622774,y94
952,54,40,94,Zr,8.666774,zr94
953,53,41,94,Nb,8.648852,nb94
954,52,42,94,Mo,8.662287000000001,mo94
955,51,43,94,Tc,8.608690000000001,tc94
956,50,44,94,Ru,8.583494,ru94
962,58,37,95,Rb,8.459813,rb95
963,57,38,95,Sr,8.549082,sr95
964,56,39,95,Y,8.604954,y95
965,55,40,95,Zr,8.643569,zr95
966,54,41,95,Nb,8.647165999999999,nb95
967,53,42,95,Mo,8.648674000000002,mo95
968,52,43,95,Tc,8.622643,tc95
969,51,44,95,Ru,8.587386,ru95
970,50,45,95,Rh,8.525362,rh95
976,59,37,96,Rb,8.407544,rb96
977,58,38,96,Sr,8.521419,sr96
978,57,39,96,Y,8.569600000000001,y96
979,56,40,96,Zr,8.635368,zr96
980,55,41,96,Nb,8.628895,nb96
981,54,42,96,Mo,8.653941,mo96
982,53,43,96,Tc,8.614821,tc96
983,52,44,96,Ru,8.609326,ru96
984,51,45,96,Rh,8.534586,rh96
985,50,46,96,Pd,8.490499,pd96
990,60,37,97,Rb,8.374508,rb97
991,59,38,97,Sr,8.473987,sr97
992,58,39,97,Y,8.542926999999999,y97
993,57,40,97,Zr,8.603819999999999,zr97
994,56,41,97,Nb,8.623166999999999,nb97
995,55,42,97,Mo,8.635048000000001,mo97
996,54,43,97,Tc,8.62368,tc97
997,53,44,97,Ru,8.604193,ru97
998,52,45,97,Rh,8.559808,rh97
999,51,46,97,Pd,8.502360999999999,pd97
1000,50,47,97,Ag,8.422336999999999,ag97
1004,61,37,98,Rb,8.329223,rb98
1005,60,38,98,Sr,8.448015999999999,sr98
1006,59,39,98,Y,8.499439,y98
1007,58,40,98,Zr,8.58145,zr98
1008,57,41,98,Nb,8.596341,nb98
1009,56,42,98,Mo,8.635125,mo98
1010,55,43,98,Tc,8.609959,tc98
1011,54,44,98,Ru,8.620309,ru98
1012,53,45,98,Rh,8.560799000000001,rh98
1013,52,46,98,Pd,8.533685,pd98
1014,51,47,98,Ag,8.441627,ag98
1015,50,48,98,Cd,8.378235,cd98
1018,62,37,99,Rb,8.292853000000001,rb99
1019,61,38,99,Sr,8.399161,sr99
1020,60,39,99,Y,8.47222,y99
1021,59,40,99,Zr,8.540758,zr99
1022,58,41,99,Nb,8.578899999999999,nb99
1023,57,42,99,Mo,8.607754000000002,mo99
1024,56,43,99,Tc,8.613562,tc99
1025,55,44,99,Ru,8.608627,ru99
1026,54,45,99,Rh,8.580093000000002,rh99
1027,53,46,99,Pd,8.537982,pd99
1028,52,47,99,Ag,8.475230999999999,ag99
1034,62,38,100,Sr,8.376218000000001,sr100
1035,61,39,100,Y,8.439145,y100
1036,60,40,100,Zr,8.524422,zr100
1037,59,41,100,Nb,8.549948,nb100
1038,58,42,100,Mo,8.604575,mo100
1039,57,43,100,Tc,8.59507,tc100
1040,56,44,100,Ru,8.619273999999999,ru100
1041,55,45,100,Rh,8.575103,rh100
1042,54,46,100,Pd,8.5637,pd100
1043,53,47,100,Ag,8.485098,ag100
1044,52,48,100,Cd,8.438289000000001,cd100
1045,51,49,100,In,8.329666,in100
1046,50,50,100,Sn,8.247941999999998,sn100
1047,64,37,101,Rb,8.216370999999999,rb101
1048,63,38,101,Sr,8.325555,sr101
1049,62,39,101,Y,8.411918,y101
1050,61,40,101,Zr,8.488776,zr101
1051,60,41,101,Nb,8.535337,nb101
1052,59,42,101,Mo,8.572829,mo101
1053,58,43,101,Tc,8.593049,tc101
1054,57,44,101,Ru,8.601282,ru101
1055,56,45,101,Rh,8.588173000000001,rh101
1056,55,46,101,Pd,8.560823000000001,pd101
1057,54,47,101,Ag,8.511455,ag101
1058,53,48,101,Cd,8.449485999999998,cd101
1062,64,38,102,Sr,8.300222,sr102
1063,63,39,102,Y,8.378974,y102
1064,62,40,102,Zr,8.467872,zr102
1065,61,41,102,Nb,8.505349,nb102
1066,60,42,102,Mo,8.568365,mo102
1067,59,43,102,Tc,8.570579,tc102
1068,58,44,102,Ru,8.607344000000001,ru102
1069,57,45,102,Rh,8.5769,rh102
1070,56,46,102,Pd,8.580504999999999,pd102
1071,55,47,102,Ag,8.517343,ag102
1072,54,48,102,Cd,8.484309999999999,cd102
1073,53,49,102,In,8.388714,in102
1074,52,50,102,Sn,8.324377,sn102
1077,63,40,103,Zr,8.431299000000001,zr103
1078,62,41,103,Nb,8.491131,nb103
1079,61,42,103,Mo,8.537225000000001,mo103
1080,60,43,103,Tc,8.566037,tc103
1081,59,44,103,Ru,8.584283000000001,ru103
1082,58,45,103,Rh,8.584100000000001,rh103
1083,57,46,103,Pd,8.571231,pd103
1084,56,47,103,Ag,8.537541,ag103
1085,55,48,103,Cd,8.489733,cd103
1086,54,49,103,In,8.423399,in103
1092,63,41,104,Nb,8.45735,nb104
1093,62,42,104,Mo,8.52776,mo104
1094,61,43,104,Tc,8.540983,tc104
1095,60,44,104,Ru,8.587333000000001,ru104
1096,59,45,104,Rh,8.568858,rh104
1097,58,46,104,Pd,8.584799,pd104
1098,57,47,104,Ag,8.536135,ag104
1099,56,48,104,Cd,8.517683000000002,cd104
1100,55,49,104,In,8.434505999999999,in104
1101,54,50,104,Sn,8.383569999999999,sn104
1106,64,41,105,Nb,8.440617,nb105
1107,63,42,105,Mo,8.494928,mo105
1108,62,43,105,Tc,8.534619000000001,tc105
1109,61,44,105,Ru,8.561834999999999,ru105
1110,60,45,105,Rh,8.572651,rh105
1111,59,46,105,Pd,8.570602,pd105
1112,58,47,105,Ag,8.550343000000002,ag105
1113,57,48,105,Cd,8.516817,cd105
1114,56,49,105,In,8.463185,in105
1115,55,50,105,Sn,8.396509,sn105
1116,54,51,105,Sb,8.29913,sb105
1121,64,42,106,Mo,8.480718000000001,mo106
1122,63,43,106,Tc,8.506545000000001,tc106
1123,62,44,106,Ru,8.560929,ru106
1124,61,45,106,Rh,8.55392,rh106
1125,60,46,106,Pd,8.579945,pd106
1126,59,47,106,Ag,8.544591,ag106
1127,58,48,106,Cd,8.539052,cd106
1128,57,49,106,In,8.470105,in106
1129,56,50,106,Sn,8.432711999999999,sn106
1131,54,52,106,Te,8.236716999999999,te106
1135,65,42,107,Mo,8.445937,mo107
1136,64,43,107,Tc,8.496195,tc107
1137,63,44,107,Ru,8.53393,ru107
1138,62,45,107,Rh,8.554099,rh107
1139,61,46,107,Pd,8.560846999999999,pd107
1140,60,47,107,Ag,8.553854,ag107
1141,59,48,107,Cd,8.533299999999999,cd107
1142,58,49,107,In,8.493977,in107
1143,57,50,107,Sn,8.440097,sn107
1150,65,43,108,Tc,8.463095,tc108
1151,64,44,108,Ru,8.527332,ru108
1152,63,45,108,Rh,8.532555,rh108
1153,62,46,108,Pd,8.567024,pd108
1154,61,47,108,Ag,8.541979999999999,ag108
1155,60,48,108,Cd,8.550018,cd108
1156,59,49,108,In,8.495211999999999,in108
1157,58,50,108,Sn,8.468758,sn108
1159,56,52,108,Te,8.303168,te108
1164,66,43,109,Tc,8.446498,tc109
1165,65,44,109,Ru,8.497257,ru109
1166,64,45,109,Rh,8.528244,rh109
1167,63,46,109,Pd,8.544883,pd109
1168,62,47,109,Ag,8.547944,ag109
1169,61,48,109,Cd,8.538801,cd109
1170,60,49,109,In,8.513095,in109
1171,59,50,109,Sn,8.470600000000001,sn109
1172,58,51,109,Sb,8.40489,sb109
1173,57,52,109,Te,8.318380999999999,te109
1174,56,53,109,I,8.219474,i109
1178,67,43,110,Tc,8.410589,tc110
1179,66,44,110,Ru,8.485485,ru110
1180,65,45,110,Rh,8.503774,rh110
1181,64,46,110,Pd,8.547328000000002,pd110
1182,63,47,110,Ag,8.532138000000002,ag110
1183,62,48,110,Cd,8.55132,cd110
1184,61,49,110,In,8.508954,in110
1185,60,50,110,Sn,8.496103999999999,sn110
1187,58,52,110,Te,8.358545,te110
1189,56,54,110,Xe,8.159116,xe110
1192,68,43,111,Tc,8.39182,tc111
1193,67,44,111,Ru,8.45188,ru111
1194,66,45,111,Rh,8.496106,rh111
1195,65,46,111,Pd,8.521914,pd111
1196,64,47,111,Ag,8.534834,ag111
1197,63,48,111,Cd,8.537127,cd111
1198,62,49,111,In,8.522315,in111
1199,61,50,111,Sn,8.493186,sn111
1200,60,51,111,Sb,8.440583,sb111
1201,59,52,111,Te,8.366839,te111
1206,69,43,112,Tc,8.360234,tc112
1207,68,44,112,Ru,8.437928,ru112
1208,67,45,112,Rh,8.468958,rh112
1209,66,46,112,Pd,8.520857,pd112
1210,65,47,112,Ag,8.516444,ag112
1211,64,48,112,Cd,8.544780000000001,cd112
1212,63,49,112,In,8.514719999999999,in112
1213,62,50,112,Sn,8.513674000000002,sn112
1214,61,51,112,Sb,8.443648000000001,sb112
1215,60,52,112,Te,8.398275,te112
1217,58,54,112,Xe,8.229531,xe112
1222,69,44,113,Ru,8.405648999999999,ru113
1223,68,45,113,Rh,8.45607,rh113
1224,67,46,113,Pd,8.493476999999999,pd113
1225,66,47,113,Ag,8.516117,ag113
1226,65,48,113,Cd,8.527040000000001,cd113
1227,64,49,113,In,8.522950999999999,in113
1228,63,50,113,Sn,8.506853999999999,sn113
1229,62,51,113,Sb,8.4653,sb113
1230,61,52,113,Te,8.404636,te113
1231,60,53,113,I,8.33383,i113
1232,59,54,113,Xe,8.246941999999999,xe113
1233,58,55,113,Cs,8.148088000000001,cs113
1237,69,45,114,Rh,8.425932,rh114
1238,68,46,114,Pd,8.488059999999999,pd114
1239,67,47,114,Ag,8.493936,ag114
1240,66,48,114,Cd,8.531565,cd114
1241,65,49,114,In,8.511994000000001,in114
1242,64,50,114,Sn,8.522575999999999,sn114
1243,63,51,114,Sb,8.462683,sb114
1244,62,52,114,Te,8.432778,te114
1246,60,54,114,Xe,8.289204999999999,xe114
1248,58,56,114,Ba,8.090038,ba114
1251,71,44,115,Ru,8.349623,ru115
1252,70,45,115,Rh,8.410472,rh115
1253,69,46,115,Pd,8.457535,pd115
1254,68,47,115,Ag,8.490593,ag115
1255,67,48,115,Cd,8.510777000000001,cd115
1256,66,49,115,In,8.516549000000001,in115
1257,65,50,115,Sn,8.514088,sn115
1258,64,51,115,Sb,8.480915000000001,sb115
1259,63,52,115,Te,8.431149999999999,te115
1260,62,53,115,I,8.374564,i115
1261,61,54,115,Xe,8.30097,xe115
1266,71,45,116,Rh,8.377612,rh116
1267,70,46,116,Pd,8.450393,pd116
1268,69,47,116,Ag,8.466121999999999,ag116
1269,68,48,116,Cd,8.51241,cd116
1270,67,49,116,In,8.501619,in116
1271,66,50,116,Sn,8.523134,sn116
1272,65,51,116,Sb,8.475813,sb116
1273,64,52,116,Te,8.455687,te116
1274,63,53,116,I,8.381902,i116
1275,62,54,116,Xe,8.336834999999999,xe116
1281,71,46,117,Pd,8.417833,pd117
1282,70,47,117,Ag,8.460163,ag117
1283,69,48,117,Cd,8.489032,cd117
1284,68,49,117,In,8.503881999999999,in117
1285,67,50,117,Sn,8.50963,sn117
1286,66,51,117,Sb,8.487941999999999,sb117
1287,65,52,117,Te,8.450931,te117
1288,64,53,117,I,8.404395000000001,i117
1289,63,54,117,Xe,8.344297,xe117
1290,62,55,117,Cs,8.271435,cs117
1296,72,46,118,Pd,8.405873999999999,pd118
1297,71,47,118,Ag,8.43399,ag118
1298,70,48,118,Cd,8.487893,cd118
1299,69,49,118,In,8.485685,in118
1300,68,50,118,Sn,8.516561,sn118
1301,67,51,118,Sb,8.478942,sb118
1302,66,52,118,Te,8.469953000000002,te118
1303,65,53,118,I,8.406119,i118
1304,64,54,118,Xe,8.374981,xe118
1305,63,55,118,Cs,8.286405,cs118
1311,72,47,119,Ag,8.422469999999999,ag119
1312,71,48,119,Cd,8.460854,cd119
1313,70,49,119,In,8.486187,in119
1314,69,50,119,Sn,8.499476999999999,sn119
1315,68,51,119,Sb,8.487937,sb119
1316,67,52,119,Te,8.462094,te119
1317,66,53,119,I,8.426789000000001,i119
1318,65,54,119,Xe,8.378440999999999,xe119
1319,64,55,119,Cs,8.317334,cs119
1320,63,56,119,Ba,8.245928,ba119
1325,74,46,120,Pd,8.355993,pd120
1326,73,47,120,Ag,8.395306999999999,ag120
1327,72,48,120,Cd,8.458162,cd120
1328,71,49,120,In,8.466318000000001,in120
1329,70,50,120,Sn,8.504548000000002,sn120
1330,69,51,120,Sb,8.47569,sb120
1331,68,52,120,Te,8.477338,te120
1332,67,53,120,I,8.424027,i120
1333,66,54,120,Xe,8.404031999999999,xe120
1334,65,55,120,Cs,8.328479999999999,cs120
1335,64,56,120,Ba,8.280294,ba120
1340,74,47,121,Ag,8.384464,ag121
1341,73,48,121,Cd,8.430890999999999,cd121
1342,72,49,121,In,8.463929,in121
1343,71,50,121,Sn,8.485256999999999,sn121
1344,70,51,121,Sb,8.482023000000002,sb121
1345,69,52,121,Te,8.46693,te121
1346,68,53,121,I,8.441754000000001,i121
1347,67,54,121,Xe,8.403764,xe121
1348,66,55,121,Cs,8.352898999999999,cs121
1349,65,56,121,Ba,8.29389,ba121
1356,74,48,122,Cd,8.425233,cd122
1357,73,49,122,In,8.442155999999999,in122
1358,72,50,122,Sn,8.487945,sn122
1359,71,51,122,Sb,8.468288000000001,sb122
1360,70,52,122,Te,8.478136999999998,te122
1361,69,53,122,I,8.437019,i122
1362,68,54,122,Xe,8.424664,xe122
1363,67,55,122,Cs,8.359110000000001,cs122
1364,66,56,122,Ba,8.323756,ba122
1370,75,48,123,Cd,8.394558000000002,cd123
1371,74,49,123,In,8.437912,in123
1372,73,50,123,Sn,8.467278,sn123
1373,72,51,123,Sb,8.472329,sb123
1374,71,52,123,Te,8.465544,te123
1375,70,53,123,I,8.449195,i123
1376,69,54,123,Xe,8.420926,xe123
1377,68,55,123,Cs,8.380379000000001,cs123
1378,67,56,123,Ba,8.330208,ba123
1384,76,48,124,Cd,8.387108,cd124
1385,75,49,124,In,8.414396,in124
1386,74,50,124,Sn,8.467440999999999,sn124
1387,73,51,124,Sb,8.456161,sb124
1388,72,52,124,Te,8.473273,te124
1389,71,53,124,I,8.441483,i124
1390,70,54,124,Xe,8.437554,xe124
1391,69,55,124,Cs,8.383431999999999,cs124
1392,68,56,124,Ba,8.35582,ba124
1393,67,57,124,La,8.278291999999999,la124
1398,77,48,125,Cd,8.357764000000001,cd125
1399,76,49,125,In,8.408482,in125
1400,75,50,125,Sn,8.445566999999999,sn125
1401,74,51,125,Sb,8.458164,sb125
1402,73,52,125,Te,8.458039000000001,te125
1403,72,53,125,I,8.450294,i125
1404,71,54,125,Xe,8.430879999999998,xe125
1405,70,55,125,Cs,8.399785,cs125
1406,69,56,125,Ba,8.35817,ba125
1407,68,57,125,La,8.304642,la125
1412,78,48,126,Cd,8.347306999999999,cd126
1413,77,49,126,In,8.384638,in126
1414,76,50,126,Sn,8.443564,sn126
1415,75,51,126,Sb,8.440355,sb126
1416,74,52,126,Te,8.463242000000001,te126
1417,73,53,126,I,8.439937,i126
1418,72,54,126,Xe,8.443712,xe126
1419,71,55,126,Cs,8.399220999999999,cs126
1420,70,56,126,Ba,8.379718,ba126
1421,69,57,126,La,8.312426,la126
1422,68,58,126,Ce,8.273257,ce126
1427,79,48,127,Cd,8.315132,cd127
1428,78,49,127,In,8.375649,in127
1429,77,50,127,Sn,8.42078,sn127
1430,76,51,127,Sb,8.439824,sb127
1431,75,52,127,Te,8.446113,te127
1432,74,53,127,I,8.445481,i127
1433,73,54,127,Xe,8.434104999999999,xe127
1434,72,55,127,Cs,8.411560999999999,cs127
1435,71,56,127,Ba,8.378437,ba127
1436,70,57,127,La,8.333538,la127
1437,69,58,127,Ce,8.280762,ce127
1442,80,48,128,Cd,8.303632,cd128
1443,79,49,128,In,8.352754999999998,in128
1444,78,50,128,Sn,8.416765,sn128
1445,77,51,128,Sb,8.420605,sb128
1446,76,52,128,Te,8.448739999999999,te128
1447,75,53,128,I,8.432829,i128
1448,74,54,128,Xe,8.443296,xe128
1449,73,55,128,Cs,8.406491,cs128
1450,72,56,128,Ba,8.39624,ba128
1451,71,57,128,La,8.33724,la128
1452,70,58,128,Ce,8.306925,ce128
1453,69,59,128,Pr,8.228913,pr128
1459,80,49,129,In,8.339564000000001,in129
1460,79,50,129,Sn,8.39284,sn129
1461,78,51,129,Sb,8.418046,sb129
1462,77,52,129,Te,8.430396,te129
1463,76,53,129,I,8.43596,i129
1464,75,54,129,Xe,8.4314,xe129
1465,74,55,129,Cs,8.416056000000001,cs129
1466,73,56,129,Ba,8.391109,ba129
1467,72,57,129,La,8.356064,la129
1468,71,58,129,Ce,8.31094,ce129
1469,70,59,129,Pr,8.25438,pr129
1474,82,48,130,Cd,8.256065999999999,cd130
1475,81,49,130,In,8.314048000000001,in130
1476,80,50,130,Sn,8.386868,sn130
1477,79,51,130,Sb,8.397409,sb130
1478,78,52,130,Te,8.430312,te130
1479,77,53,130,I,8.421071,i130
1480,76,54,130,Xe,8.43774,xe130
1481,75,55,130,Cs,8.408789,cs130
1482,74,56,130,Ba,8.405549,ba130
1483,73,57,130,La,8.356196,la130
1484,72,58,130,Ce,8.333216,ce130
1485,71,59,130,Pr,8.263755999999999,pr130
1486,70,60,130,Nd,8.222513000000001,nd130
1491,82,49,131,In,8.298814,in131
1492,81,50,131,Sn,8.362896000000001,sn131
1493,80,51,131,Sb,8.392601999999998,sb131
1494,79,52,131,Te,8.411221,te131
1495,78,53,131,I,8.422309,i131
1496,77,54,131,Xe,8.423748,xe131
1497,76,55,131,Cs,8.415063,cs131
1498,75,56,131,Ba,8.398587,ba131
1499,74,57,131,La,8.370367,la131
1500,73,58,131,Ce,8.333449,ce131
1501,72,59,131,Pr,8.285972,pr131
1502,71,60,131,Nd,8.230311,nd131
1507,83,49,132,In,8.253773,in132
1508,82,50,132,Sn,8.35493,sn132
1509,81,51,132,Sb,8.372634,sb132
1510,80,52,132,Te,8.40844,te132
1511,79,53,132,I,8.406435,i132
1512,78,54,132,Xe,8.427633,xe132
1513,77,55,132,Cs,8.405612,cs132
1514,76,56,132,Ba,8.409373,ba132
1515,75,57,132,La,8.367880999999999,la132
1516,74,58,132,Ce,8.352362,ce132
1517,73,59,132,Pr,8.291431000000001,pr132
1518,72,60,132,Nd,8.25681,nd132
1523,83,50,133,Sn,8.31068,sn133
1524,82,51,133,Sb,8.364873,sb133
1525,81,52,133,Te,8.389081000000001,te133
1526,80,53,133,I,8.405318999999999,i133
1527,79,54,133,Xe,8.412647,xe133
1528,78,55,133,Cs,8.409978,cs133
1529,77,56,133,Ba,8.400205,ba133
1530,76,57,133,La,8.378841,la133
1531,75,58,133,Ce,8.349867,ce133
1532,74,59,133,Pr,8.310258,pr133
1533,73,60,133,Nd,8.262231,nd133
1534,72,61,133,Pm,8.204283000000002,pm133
1538,84,50,134,Sn,8.277873,sn134
1539,83,51,134,Sb,8.327034,sb134
1540,82,52,134,Te,8.383835999999999,te134
1541,81,53,134,I,8.389288,i134
1542,80,54,134,Xe,8.413689,xe134
1543,79,55,134,Cs,8.398646000000001,cs134
1544,78,56,134,Ba,8.408171,ba134
1545,77,57,134,La,8.374488000000001,la134
1546,76,58,134,Ce,8.365794,ce134
1547,75,59,134,Pr,8.312777,pr134
1548,74,60,134,Nd,8.285538,nd134
1549,73,61,134,Pm,8.213225,pm134
1555,84,51,135,Sb,8.292117000000001,sb135
1556,83,52,135,Te,8.34647,te135
1557,82,53,135,I,8.384838,i135
1558,81,54,135,Xe,8.398504999999998,xe135
1559,80,55,135,Cs,8.401337999999999,cs135
1560,79,56,135,Ba,8.397533000000001,ba135
1561,78,57,135,La,8.382849,la135
1562,77,58,135,Ce,8.362049,ce135
1563,76,59,135,Pr,8.328928,pr135
1564,75,60,135,Nd,8.288154,nd135
1565,74,61,135,Pm,8.236165000000002,pm135
1566,73,62,135,Sm,8.177626,sm135
1571,84,52,136,Te,8.319429,te136
1572,83,53,136,I,8.350985999999999,i136
1573,82,54,136,Xe,8.396158000000002,xe136
1574,81,55,136,Cs,8.38977,cs136
1575,80,56,136,Ba,8.402754999999999,ba136
1576,79,57,136,La,8.376046,la136
1577,78,58,136,Ce,8.373466,ce136
1578,77,59,136,Pr,8.329911,pr136
1579,76,60,136,Nd,8.308511999999999,nd136
1580,75,61,136,Pm,8.243926,pm136
1581,74,62,136,Sm,8.205915999999998,sm136
1587,85,52,137,Te,8.282114,te137
1588,84,53,137,I,8.327072,i137
1589,83,54,137,Xe,8.364256,xe137
1590,82,55,137,Cs,8.388956,cs137
1591,81,56,137,Ba,8.391827,ba137
1592,80,57,137,La,8.381585999999999,la137
1593,79,58,137,Ce,8.366955,ce137
1594,78,59,137,Pr,8.341528,pr137
1595,77,60,137,Nd,8.309561,nd137
1596,76,61,137,Pm,8.263651,pm137
1597,75,62,137,Sm,8.213798,sm137
1603,85,53,138,I,8.294988000000002,i138
1604,84,54,138,Xe,8.345985,xe138
1605,83,55,138,Cs,8.360146,cs138
1606,82,56,138,Ba,8.39342,ba138
1607,81,57,138,La,8.375164,la138
1608,80,58,138,Ce,8.377059000000001,ce138
1609,79,59,138,Pr,8.339238000000002,pr138
1610,78,60,138,Nd,8.3255,nd138
1611,77,61,138,Pm,8.268543,pm138
1612,76,62,138,Sm,8.237928,sm138
1613,75,63,138,Eu,8.16162,eu138
1619,86,53,139,I,8.268248999999999,i139
1620,85,54,139,Xe,8.311585,xe139
1621,84,55,139,Cs,8.342338,cs139
1622,83,56,139,Ba,8.367017,ba139
1623,82,57,139,La,8.378063000000001,la139
1624,81,58,139,Ce,8.370428,ce139
1625,80,59,139,Pr,8.349482,pr139
1626,79,60,139,Nd,8.323482,nd139
1627,78,61,139,Pm,8.285514000000001,pm139
1628,77,62,139,Sm,8.243078,sm139
1629,76,63,139,Eu,8.187218000000001,eu139
1635,86,54,140,Xe,8.290919,xe140
1636,85,55,140,Cs,8.314331,cs140
1637,84,56,140,Ba,8.353174000000001,ba140
1638,83,57,140,La,8.355083,la140
1639,82,58,140,Ce,8.376368000000001,ce140
1640,81,59,140,Pr,8.34658,pr140
1641,80,60,140,Nd,8.337824000000001,nd140
1642,79,61,140,Pm,8.289056,pm140
1643,78,62,140,Sm,8.263819999999999,sm140
1644,77,63,140,Eu,8.197732,eu140
1645,76,64,140,Gd,8.154975,gd140
1646,75,65,140,Tb,8.068672,tb140
1651,87,54,141,Xe,8.256283000000002,xe141
1652,86,55,141,Cs,8.294351,cs141
1653,85,56,141,Ba,8.326028,ba141
1654,84,57,141,La,8.343264000000001,la141
1655,83,58,141,Ce,8.355459000000002,ce141
1656,82,59,141,Pr,8.354029,pr141
1657,81,60,141,Nd,8.335552,nd141
1658,80,61,141,Pm,8.30394,pm141
1659,79,62,141,Sm,8.265879,sm141
1660,78,63,141,Eu,8.217690999999999,eu141
1661,77,64,141,Gd,8.164608,gd141
1662,76,65,141,Tb,8.097475000000001,tb141
1667,88,54,142,Xe,8.234896999999998,xe142
1668,87,55,142,Cs,8.264880999999999,cs142
1669,86,56,142,Ba,8.310836,ba142
1670,85,57,142,La,8.320902,la142
1671,84,58,142,Ce,8.347108,ce142
1672,83,59,142,Pr,8.336347,pr142
1673,82,60,142,Nd,8.346065999999999,nd142
1674,81,61,142,Pm,8.306766,pm142
1675,80,62,142,Sm,8.286017,sm142
1676,79,63,142,Eu,8.226472,eu142
1677,78,64,142,Gd,8.190256,gd142
1683,88,55,143,Cs,8.243641,cs143
1684,87,56,143,Ba,8.281977,ba143
1685,86,57,143,La,8.306235000000001,la143
1686,85,58,143,Ce,8.324715,ce143
1687,84,59,143,Pr,8.329464,pr143
1688,83,60,143,Nd,8.330523999999999,nd143
1689,82,61,143,Pm,8.317769,pm143
1690,81,62,143,Sm,8.288224,sm143
1691,80,63,143,Eu,8.245824,eu143
1692,79,64,143,Gd,8.198326,gd143
1693,78,65,143,Tb,8.138323,tb143
1699,89,55,144,Cs,8.211879000000001,cs144
1700,88,56,144,Ba,8.265467,ba144
1701,87,57,144,La,8.281725,la144
1702,86,58,144,Ce,8.314795,ce144
1703,85,59,144,Pr,8.311575000000001,pr144
1704,84,60,144,Nd,8.326959,nd144
1705,83,61,144,Pm,8.305331,pm144
1706,82,62,144,Sm,8.303723,sm144
1707,81,63,144,Eu,8.254190999999999,eu144
1708,80,64,144,Gd,8.221937,gd144
1709,79,65,144,Tb,8.151287,tb144
1710,78,66,144,Dy,8.10569,dy144
1714,90,55,145,Cs,8.188751,cs145
1715,89,56,145,Ba,8.2341,ba145
1716,88,57,145,La,8.267131,la145
1717,87,58,145,Ce,8.290081,ce145
1718,86,59,145,Pr,8.302168,pr145
1719,85,60,145,Nd,8.309223,nd145
1720,84,61,145,Pm,8.302700999999999,pm145
1721,83,62,145,Sm,8.293057,sm145
1722,82,63,145,Eu,8.269321,eu145
1723,81,64,145,Gd,8.228953,gd145
1724,80,65,145,Tb,8.174961,tb145
1725,79,66,145,Dy,8.117201999999999,dy145
1730,91,55,146,Cs,8.157557,cs146
1731,90,56,146,Ba,8.216445,ba146
1732,89,57,146,La,8.239325000000001,la146
1733,88,58,146,Ce,8.278846999999999,ce146
1734,87,59,146,Pr,8.2806,pr146
1735,86,60,146,Nd,8.304127000000001,nd146
1736,85,61,146,Pm,8.288692,pm146
1737,84,62,146,Sm,8.293895000000001,sm146
1738,83,63,146,Eu,8.261964,eu146
1739,82,64,146,Gd,8.249557,gd146
1740,81,65,146,Tb,8.187186,tb146
1741,80,66,146,Dy,8.146107,dy146
1746,92,55,147,Cs,8.132475000000001,cs147
1748,90,57,147,La,8.222709,la147
1749,89,58,147,Ce,8.252628000000001,ce147
1750,88,59,147,Pr,8.270612,pr147
1751,87,60,147,Nd,8.283638000000002,nd147
1752,86,61,147,Pm,8.284411,pm147
1753,85,62,147,Sm,8.280614,sm147
1754,84,63,147,Eu,8.26358,eu147
1755,83,64,147,Gd,8.243378,gd147
1756,82,65,147,Tb,8.206688,tb147
1757,81,66,147,Dy,8.156711999999999,dy147
1758,80,67,147,Ho,8.094584,ho147
1761,93,55,148,Cs,8.100195,cs148
1762,92,56,148,Ba,8.167276999999999,ba148
1763,91,57,148,La,8.196551,la148
1764,90,58,148,Ce,8.240335,ce148
1765,89,59,148,Pr,8.249508,pr148
1766,88,60,148,Nd,8.277213,nd148
1767,87,61,148,Pm,8.268268,pm148
1768,86,62,148,Sm,8.279673,sm148
1769,85,63,148,Eu,8.253849,eu148
1770,84,64,148,Gd,8.248382,gd148
1771,83,65,148,Tb,8.204344,tb148
1772,82,66,148,Dy,8.180943000000001,dy148
1773,81,67,148,Ho,8.109142,ho148
1780,91,58,149,Ce,8.214396999999998,ce149
1781,90,59,149,Pr,8.238418,pr149
1782,89,60,149,Nd,8.255479,nd149
1783,88,61,149,Pm,8.261573,pm149
1784,87,62,149,Sm,8.263508,sm149
1785,86,63,149,Eu,8.25359,eu149
1786,85,64,149,Gd,8.239527,gd149
1787,84,65,149,Tb,8.209864,tb149
1788,83,66,149,Dy,8.179238,dy149
1789,82,67,149,Ho,8.13354,ho149
1790,81,68,149,Er,8.074955,er149
1796,92,58,150,Ce,8.200968000000001,ce150
1797,91,59,150,Pr,8.218952,pr150
1798,90,60,150,Nd,8.249643,nd150
1799,89,61,150,Pm,8.243851999999999,pm150
1800,88,62,150,Sm,8.261663,sm150
1801,87,63,150,Eu,8.24138,eu150
1802,86,64,150,Gd,8.242640999999999,gd150
1803,85,65,150,Tb,8.206370999999999,tb150
1804,84,66,150,Dy,8.189198000000001,dy150
1805,83,67,150,Ho,8.134855,ho150
1806,82,68,150,Er,8.102206,er150
1813,93,58,151,Ce,8.178103,ce151
1814,92,59,151,Pr,8.207823000000001,pr151
1815,91,60,151,Nd,8.230338,nd151
1816,90,61,151,Pm,8.241331,pm151
1817,89,62,151,Sm,8.244012,sm151
1818,88,63,151,Eu,8.239339,eu151
1819,87,64,151,Gd,8.231084000000001,gd151
1820,86,65,151,Tb,8.208913,tb151
1821,85,66,151,Dy,8.184719,dy151
1822,84,67,151,Ho,8.145588,ho151
1823,83,68,151,Er,8.104869,er151
1824,82,69,151,Tm,8.050124,tm151
1825,81,70,151,Yb,7.983765,yb151
1830,93,59,152,Pr,8.187433,pr152
1831,92,60,152,Nd,8.224062,nd152
1832,91,61,152,Pm,8.226180000000001,pm152
1833,90,62,152,Sm,8.244102,sm152
1834,89,63,152,Eu,8.226624,eu152
1835,88,64,152,Gd,8.233449,gd152
1836,87,65,152,Tb,8.202052,tb152
1837,86,66,152,Dy,8.192959,dy152
1838,85,67,152,Ho,8.144941999999999,ho152
1839,84,68,152,Er,8.119347,er152
1840,83,69,152,Tm,8.056769000000001,tm152
1841,82,70,152,Yb,8.015668,yb152
1846,94,59,153,Pr,8.17243,pr153
1847,93,60,153,Nd,8.204702,nd153
1848,92,61,153,Pm,8.221392,pm153
1849,91,62,153,Sm,8.228574,sm153
1850,90,63,153,Eu,8.22874,eu153
1851,89,64,153,Gd,8.220465,gd153
1852,88,65,153,Tb,8.205093000000002,tb153
1853,87,66,153,Dy,8.185793,dy153
1854,86,67,153,Ho,8.153684,ho153
1855,85,68,153,Er,8.118954,er153
1856,84,69,153,Tm,8.071536,tm153
1858,82,71,153,Lu,7.9593,lu153
1862,95,59,154,Pr,8.149519,pr154
1863,94,60,154,Nd,8.193075,nd154
1864,93,61,154,Pm,8.206221,pm154
1865,92,62,154,Sm,8.226876,sm154
1866,91,63,154,Eu,8.217139000000001,eu154
1867,90,64,154,Gd,8.224843,gd154
1868,89,65,154,Tb,8.196703000000001,tb154
1869,88,66,154,Dy,8.193157,dy154
1870,87,67,154,Ho,8.150713000000001,ho154
1871,86,68,154,Er,8.132438,er154
1872,85,69,154,Tm,8.074221999999999,tm154
1873,84,70,154,Yb,8.03995,yb154
1880,94,61,155,Pm,8.195511,pm155
1881,93,62,155,Sm,8.211264000000002,sm155
1882,92,63,155,Eu,8.216715,eu155
1883,91,64,155,Gd,8.213296999999999,gd155
1884,90,65,155,Tb,8.202941999999998,tb155
1885,89,66,155,Dy,8.184382,dy155
1886,88,67,155,Ho,8.159204,ho155
1887,87,68,155,Er,8.129484,er155
1888,86,69,155,Tm,8.088436,tm155
1889,85,70,155,Yb,8.043828000000001,yb155
1890,84,71,155,Lu,7.987495,lu155
1895,96,60,156,Nd,8.158429,nd156
1896,95,61,156,Pm,8.177068,pm156
1897,94,62,156,Sm,8.205065999999999,sm156
1898,93,63,156,Eu,8.204681999999998,eu156
1899,92,64,156,Gd,8.215368,gd156
1900,91,65,156,Tb,8.194681999999998,tb156
1901,90,66,156,Dy,8.192439,dy156
1902,89,67,156,Ho,8.154249,ho156
1903,88,68,156,Er,8.141915,er156
1904,87,69,156,Tm,8.089637,tm156
1905,86,70,156,Yb,8.061703,yb156
1906,85,71,156,Lu,7.995696999999999,lu156
1907,84,72,156,Hf,7.952876,hf156
1912,96,61,157,Pm,8.164631,pm157
1913,95,62,157,Sm,8.187419,sm157
1914,94,63,157,Eu,8.19985,eu157
1915,93,64,157,Gd,8.20355,gd157
1916,92,65,157,Tb,8.198184000000001,tb157
1917,91,66,157,Dy,8.184648,dy157
1918,90,67,157,Ho,8.163111,ho157
1919,89,68,157,Er,8.136414,er157
1920,88,69,157,Tm,8.101428,tm157
1921,87,70,157,Yb,8.062894,yb157
1922,86,71,157,Lu,8.013588,lu157
1924,84,73,157,Ta,7.896268,ta157
1927,97,61,158,Pm,8.143276,pm158
1928,96,62,158,Sm,8.177059,sm158
1929,95,63,158,Eu,8.184759,eu158
1930,94,64,158,Gd,8.201865,gd158
1931,93,65,158,Tb,8.189195,tb158
1932,92,66,158,Dy,8.19016,dy158
1933,91,67,158,Ho,8.158493,ho158
1934,90,68,158,Er,8.147926,er158
1935,89,69,158,Tm,8.101199000000001,tm158
1936,88,70,158,Yb,8.079232,yb158
1937,87,71,158,Lu,8.018581,lu158
1938,86,72,158,Hf,7.981286,hf158
1944,97,62,159,Sm,8.15753,sm159
1945,96,63,159,Eu,8.17676,eu159
1946,95,64,159,Gd,8.187659,gd159
1947,94,65,159,Tb,8.188842,tb159
1948,93,66,159,Dy,8.181623,dy159
1949,92,67,159,Ho,8.165145,ho159
1950,91,68,159,Er,8.142813,er159
1951,90,69,159,Tm,8.112754,tm159
1952,89,70,159,Yb,8.078101,yb159
1953,88,71,159,Lu,8.03464,lu159
1954,87,72,159,Hf,7.986566,hf159
1955,86,73,159,Ta,7.928783,ta159
1961,96,64,160,Gd,8.183057,gd160
1962,95,65,160,Tb,8.177507,tb160
1963,94,66,160,Dy,8.184087,dy160
1964,93,67,160,Ho,8.158635,ho160
1965,92,68,160,Er,8.151685,er160
1966,91,69,160,Tm,8.11082,tm160
1967,90,70,160,Yb,8.092601,yb160
1968,89,71,160,Lu,8.038338000000001,lu160
1969,88,72,160,Hf,8.006369000000001,hf160
1970,87,73,160,Ta,7.938593000000001,ta160
1971,86,74,160,W,7.892993000000001,w160
1977,97,64,161,Gd,8.167233,gd161
1978,96,65,161,Tb,8.174520000000001,tb161
1979,95,66,161,Dy,8.173344,dy161
1980,94,67,161,Ho,8.163153,ho161
1981,93,68,161,Er,8.14591,er161
1982,92,69,161,Tm,8.12049,tm161
1983,91,70,161,Yb,8.090447,yb161
1984,90,71,161,Lu,8.052781,lu161
1985,89,72,161,Hf,8.009142,hf161
1988,86,75,161,Re,7.836531999999999,re161
1992,98,64,162,Gd,8.159077,gd162
1993,97,65,162,Tb,8.162853,tb162
1994,96,66,162,Dy,8.17349,dy162
1995,95,67,162,Ho,8.155451999999999,ho162
1996,94,68,162,Er,8.152446999999999,er162
1997,93,69,162,Tm,8.117624,tm162
1998,92,70,162,Yb,8.102597,yb162
1999,91,71,162,Lu,8.054590000000001,lu162
2000,90,72,162,Hf,8.027145,hf162
2001,89,73,162,Ta,7.964348000000001,ta162
2002,88,74,162,W,7.923837,w162
2009,98,65,163,Tb,8.155666,tb163
2010,97,66,163,Dy,8.161818,dy163
2011,96,67,163,Ho,8.157002,ho163
2012,95,68,163,Er,8.144779999999999,er163
2013,94,69,163,Tm,8.125017,tm163
2014,93,70,163,Yb,8.09917,yb163
2015,92,71,163,Lu,8.066684,lu163
2016,91,72,163,Hf,8.02811,hf163
2017,90,73,163,Ta,7.981929,ta163
2018,89,74,163,W,7.930308000000001,w163
2019,88,75,163,Re,7.870893,re163
2024,99,65,164,Tb,8.139797,tb164
2025,98,66,164,Dy,8.158746,dy164
2026,97,67,164,Ho,8.147963,ho164
2027,96,68,164,Er,8.149061,er164
2028,95,69,164,Tm,8.119528,tm164
2029,94,70,164,Yb,8.109478,yb164
2030,93,71,164,Lu,8.065803,lu164
2031,92,72,164,Hf,8.043833000000001,hf164
2032,91,73,164,Ta,7.986997,ta164
2033,90,74,164,W,7.95144,w164
2035,88,76,164,Os,7.83352,os164
2041,99,66,165,Dy,8.143942,dy165
2042,98,67,165,Ho,8.146998,ho165
2043,97,68,165,Er,8.139975999999999,er165
2044,96,69,165,Tm,8.125584,tm165
2045,95,70,165,Yb,8.10479,yb165
2046,94,71,165,Lu,8.076745,lu165
2047,93,72,165,Hf,8.042872,hf165
2048,92,73,165,Ta,8.003098000000001,ta165
2049,91,74,165,W,7.955974,w165
2050,90,75,165,Re,7.901504,re165
2055,101,65,166,Tb,8.112929,tb166
2056,100,66,166,Dy,8.137313,dy166
2057,99,67,166,Ho,8.135532,ho166
2058,98,68,166,Er,8.141992,er166
2059,97,69,166,Tm,8.118979999999999,tm166
2060,96,70,166,Yb,8.112427,yb166
2061,95,71,166,Lu,8.074175,lu166
2062,94,72,166,Hf,8.056438,hf166
2063,93,73,166,Ta,8.004971,ta166
2064,92,74,166,W,7.974920999999999,w166
2066,90,76,166,Os,7.866378000000001,os166
2072,101,66,167,Dy,8.121028,dy167
2073,100,67,167,Ho,8.130415,ho167
2074,99,68,167,Er,8.131779,er167
2075,98,69,167,Tm,8.122613,tm167
2076,97,70,167,Yb,8.106226,yb167
2077,96,71,167,Lu,8.083021,lu167
2078,95,72,167,Hf,8.054184,hf167
2079,94,73,167,Ta,8.018861,ta167
2080,93,74,167,W,7.976675999999999,w167
2082,91,76,167,Os,7.873979,os167
2083,90,77,167,Ir,7.812863,ir167
2087,102,66,168,Dy,8.112563,dy168
2088,101,67,168,Ho,8.116850000000001,ho168
2089,100,68,168,Er,8.129634,er168
2090,99,69,168,Tm,8.114982,tm168
2091,98,70,168,Yb,8.111855,yb168
2092,97,71,168,Lu,8.080350000000001,lu168
2093,96,72,168,Hf,8.065553000000001,hf168
2094,95,73,168,Ta,8.019428000000001,ta168
2095,94,74,168,W,7.9939160000000005,w168
2096,93,75,168,Re,7.9351199999999995,re168
2097,92,76,168,Os,7.895914,os168
2099,90,78,168,Pt,7.773784000000001,pt168
2102,103,66,169,Dy,8.094798,dy169
2103,102,67,169,Ho,8.109103,ho169
2104,101,68,169,Er,8.117052,er169
2105,100,69,169,Tm,8.114501,tm169
2106,99,70,169,Yb,8.104489000000001,yb169
2107,98,71,169,Lu,8.086292,lu169
2108,97,72,169,Hf,8.061778,hf169
2109,96,73,169,Ta,8.030956999999999,ta169
2110,95,74,169,W,7.994536999999999,w169
2111,94,75,169,Re,7.951257,re169
2112,93,76,169,Os,7.901276,os169
2113,92,77,169,Ir,7.845521,ir169
2118,103,67,170,Ho,8.093831,ho170
2119,102,68,170,Er,8.111994000000001,er170
2120,101,69,170,Tm,8.105545,tm170
2121,100,70,170,Yb,8.106639,yb170
2122,99,71,170,Lu,8.081691,lu170
2123,98,72,170,Hf,8.070875,hf170
2124,97,73,170,Ta,8.030296,ta170
2125,96,74,170,W,8.008962,w170
2126,95,75,170,Re,7.955092,re170
2127,94,76,170,Os,7.921137,os170
2129,92,78,170,Pt,7.808273,pt170
2133,104,67,171,Ho,8.083642,ho171
2134,103,68,171,Er,8.097781,er171
2135,102,69,171,Tm,8.101923000000001,tm171
2136,101,70,171,Yb,8.097913,yb171
2137,100,71,171,Lu,8.084691,lu171
2138,99,72,171,Hf,8.066068,hf171
2139,98,73,171,Ta,8.039791000000001,ta171
2140,97,74,171,W,8.008115,w171
2141,96,75,171,Re,7.969411999999999,re171
2142,95,76,171,Os,7.924151999999999,os171
2143,94,77,171,Ir,7.873595,ir171
2144,93,78,171,Pt,7.816624,pt171
2145,92,79,171,Au,7.7541210000000005,au171
2149,104,68,172,Er,8.090444,er172
2150,103,69,172,Tm,8.091073,tm172
2151,102,70,172,Yb,8.097456999999999,yb172
2152,101,71,172,Lu,8.078263000000002,lu172
2153,100,72,172,Hf,8.071751,hf172
2154,99,73,172,Ta,8.037705,ta172
2155,98,74,172,W,8.020175,w172
2156,97,75,172,Re,7.971591999999999,re172
2157,96,76,172,Os,7.9421289999999996,os172
2159,94,78,172,Pt,7.839212,pt172
2161,92,80,172,Hg,7.713756999999999,hg172
2165,104,69,173,Tm,8.084479,tm173
2166,103,70,173,Yb,8.087456,yb173
2167,102,71,173,Lu,8.079058000000002,lu173
2168,101,72,173,Hf,8.066016,hf173
2169,100,73,173,Ta,8.044064,ta173
2170,99,74,173,W,8.018333,w173
2171,98,75,173,Re,7.983906,re173
2172,97,76,173,Os,7.944033,os173
2173,96,77,173,Ir,7.898086999999999,ir173
2174,95,78,173,Pt,7.845413000000001,pt173
2175,94,79,173,Au,7.788163000000001,au173
2179,105,69,174,Tm,8.070672,tm174
2180,104,70,174,Yb,8.083876,yb174
2181,103,71,174,Lu,8.071482,lu174
2182,102,72,174,Hf,8.068545,hf174
2183,101,73,174,Ta,8.040452,ta174
2184,100,74,174,W,8.027256,w174
2185,99,75,174,Re,7.985094,re174
2186,98,76,174,Os,7.959465999999999,os174
2187,97,77,174,Ir,7.902513000000001,ir174
2188,96,78,174,Pt,7.866121999999999,pt174
2190,94,80,174,Hg,7.749821,hg174
2193,106,69,175,Tm,8.061795,tm175
2194,105,70,175,Yb,8.070954,yb175
2195,104,71,175,Lu,8.069169,lu175
2196,103,72,175,Hf,8.060774,hf175
2197,102,73,175,Ta,8.044445,ta175
2198,101,74,175,W,8.024111999999999,w175
2199,100,75,175,Re,7.994816,re175
2200,99,76,175,Os,7.960725,os175
2201,98,77,175,Ir,7.918105,ir175
2202,97,78,175,Pt,7.869415,pt175
2203,96,79,175,Au,7.817818,au175
2204,95,80,175,Hg,7.759325,hg175
2206,107,69,176,Tm,8.045137,tm176
2207,106,70,176,Yb,8.0641,yb176
2208,105,71,176,Lu,8.059049,lu176
2209,104,72,176,Hf,8.061366,hf176
2210,103,73,176,Ta,8.03867,ta176
2211,102,74,176,W,8.030111999999999,w176
2212,101,75,176,Re,7.99397,re176
2213,100,76,176,Os,7.972678000000001,os176
2214,99,77,176,Ir,7.921433000000001,ir176
2215,98,78,176,Pt,7.888958000000001,pt176
2217,96,80,176,Hg,7.7826319999999996,hg176
2221,107,70,177,Yb,8.049989,yb177
2222,106,71,177,Lu,8.053478,lu177
2223,105,72,177,Hf,8.051886,hf177
2224,104,73,177,Ta,8.040878000000001,ta177
2225,103,74,177,W,8.025034999999999,w177
2226,102,75,177,Re,8.001222,re177
2227,101,76,177,Os,7.972397,os177
2228,100,77,177,Ir,7.934632,ir177
2229,99,78,177,Pt,7.892489,pt177
2230,98,79,177,Au,7.843887,au177
2231,97,80,177,Hg,7.789922,hg177
2232,96,81,177,Tl,7.732095999999999,tl177
2234,108,70,178,Yb,8.042857,yb178
2235,107,71,178,Lu,8.042083,lu178
2236,106,72,178,Hf,8.049493,hf178
2237,105,73,178,Ta,8.034215999999999,ta178
2238,104,74,178,W,8.029308,w178
2239,103,75,178,Re,7.998156999999999,re178
2240,102,76,178,Os,7.981923000000001,os178
2241,101,77,178,Ir,7.936549,ir178
2242,100,78,178,Pt,7.9082550000000005,pt178
2243,99,79,178,Au,7.849524000000001,au178
2244,98,80,178,Hg,7.811368000000001,hg178
2246,96,82,178,Pb,7.690866,pb178
2249,108,71,179,Lu,8.035102,lu179
2250,107,72,179,Hf,8.038596,hf179
2251,106,73,179,Ta,8.033636,ta179
2252,105,74,179,W,8.023328000000001,w179
2253,104,75,179,Re,8.003776,re179
2254,103,76,179,Os,7.979483,os179
2255,102,77,179,Ir,7.9475,ir179
2256,101,78,179,Pt,7.910651,pt179
2257,100,79,179,Au,7.865433000000001,au179
2258,99,80,179,Hg,7.816199,hg179
2259,98,81,179,Tl,7.763666,tl179
2262,109,71,180,Lu,8.022088,lu180
2263,108,72,180,Hf,8.034981,hf180
2264,107,73,180,Ta,8.0259,ta180
2265,106,74,180,W,8.025488000000001,w180
2266,105,75,180,Re,8.000004,re180
2267,104,76,180,Os,7.987431,os180
2268,103,77,180,Ir,7.947633000000001,ir180
2269,102,78,180,Pt,7.923611,pt180
2270,101,79,180,Au,7.870156,au180
2271,100,80,180,Hg,7.8360780000000005,hg180
2273,98,82,180,Pb,7.725688,pb180
2276,109,72,181,Hf,8.022052,hf181
2277,108,73,181,Ta,8.023418000000001,ta181
2278,107,74,181,W,8.018059000000001,w181
2279,106,75,181,Re,8.004109999999999,re181
2280,105,76,181,Os,7.983441999999999,os181
2281,104,77,181,Ir,7.9565719999999995,ir181
2282,103,78,181,Pt,7.924088,pt181
2283,102,79,181,Au,7.883835,au181
2284,101,80,181,Hg,7.839679,hg181
2285,100,81,181,Tl,7.791931,tl181
2286,99,82,181,Pb,7.7342580000000005,pb181
2288,110,72,182,Hf,8.014885999999999,hf182
2289,109,73,182,Ta,8.012647,ta182
2290,108,74,182,W,8.018316,w182
2291,107,75,182,Re,7.998633000000001,re182
2292,106,76,182,Os,7.989728,os182
2293,105,77,182,Ir,7.954894,ir182
2294,104,78,182,Pt,7.934758,pt182
2295,103,79,182,Au,7.887226,au182
2296,102,80,182,Hg,7.856968000000001,hg182
2297,101,81,182,Tl,7.796486999999999,tl182
2298,100,82,182,Pb,7.756338,pb182
2300,111,72,183,Hf,8.000045,hf183
2301,110,73,183,Ta,8.006753,ta183
2302,109,74,183,W,8.008329999999999,w183
2303,108,75,183,Re,8.001017,re183
2304,107,76,183,Os,7.985002,os183
2305,106,77,183,Ir,7.96179,ir183
2306,105,78,183,Pt,7.933336,pt183
2307,104,79,183,Au,7.898538,au183
2308,103,80,183,Hg,7.859361,hg183
2309,102,81,183,Tl,7.815674,tl183
2310,101,82,183,Pb,7.762116999999999,pb183
2312,112,72,184,Hf,7.990732,hf184
2313,111,73,184,Ta,7.993763,ta184
2314,110,74,184,W,8.005087,w184
2315,109,75,184,Re,7.992788000000001,re184
2316,108,76,184,Os,7.988696,os184
2317,107,77,184,Ir,7.959198000000001,ir184
2318,106,78,184,Pt,7.942562,pt184
2319,105,79,184,Au,7.900194000000001,au184
2320,104,80,184,Hg,7.8743680000000005,hg184
2321,103,81,184,Tl,7.818681,tl184
2322,102,82,184,Pb,7.782691999999999,pb184
2325,112,73,185,Ta,7.98637,ta185
2326,111,74,185,W,7.992916999999999,w185
2327,110,75,185,Re,7.991026,re185
2328,109,76,185,Os,7.981323000000001,os185
2329,108,77,185,Ir,7.963722,ir185
2330,107,78,185,Pt,7.93975,pt185
2331,106,79,185,Au,7.9094880000000005,au185
2332,105,80,185,Hg,7.874496,hg185
2333,104,81,185,Tl,7.835564000000001,tl185
2334,103,82,185,Pb,7.786932,pb185
2337,113,73,186,Ta,7.97184,ta186
2338,112,74,186,W,7.988607,w186
2339,111,75,186,Re,7.981286,re186
2340,110,76,186,Os,7.982829000000001,os186
2341,109,77,186,Ir,7.95805,ir186
2342,108,78,186,Pt,7.946809,pt186
2343,107,79,186,Au,7.90954,au186
2344,106,80,186,Hg,7.888260999999999,hg186
2345,105,81,186,Tl,7.839167,tl186
2346,104,82,186,Pb,7.805343000000001,pb186
2347,103,83,186,Bi,7.7392449999999995,bi186
2350,113,74,187,W,7.9751199999999995,w187
2351,112,75,187,Re,7.9779469999999995,re187
2352,111,76,187,Os,7.973776,os187
2353,110,77,187,Ir,7.961558000000001,ir187
2354,109,78,187,Pt,7.941316999999999,pt187
2355,108,79,187,Au,7.917305000000001,au187
2356,107,80,187,Hg,7.886986,hg187
2357,106,81,187,Tl,7.852458,tl187
2358,105,82,187,Pb,7.808363,pb187
2359,104,83,187,Bi,7.7581549999999995,bi187
2362,114,74,188,W,7.969048000000001,w188
2363,113,75,188,Re,7.966743,re188
2364,112,76,188,Os,7.973859999999999,os188
2365,111,77,188,Ir,7.9547609999999995,ir188
2366,110,78,188,Pt,7.947912,pt188
2367,109,79,188,Au,7.914378000000001,au188
2368,108,80,188,Hg,7.899050999999999,hg188
2369,107,81,188,Tl,7.853108,tl188
2370,106,82,188,Pb,7.824844,pb188
2371,105,83,188,Bi,7.764244000000001,bi188
2372,104,84,188,Po,7.724621999999999,po188
2374,115,74,189,W,7.952715,w189
2375,114,75,189,Re,7.961804,re189
2376,113,76,189,Os,7.962995,os189
2377,112,77,189,Ir,7.9560390000000005,ir189
2378,111,78,189,Pt,7.941477,pt189
2379,110,79,189,Au,7.921986999999999,au189
2380,109,80,189,Hg,7.896941999999999,hg189
2381,108,81,189,Tl,7.8661959999999995,tl189
2382,107,82,189,Pb,7.826479999999999,pb189
2383,106,83,189,Bi,7.78098,bi189
2384,105,84,189,Po,7.731096,po189
2386,116,74,190,W,7.947121,w190
2387,115,75,190,Re,7.949687,re190
2388,114,76,190,Os,7.962096,os190
2389,113,77,190,Ir,7.947688,ir190
2390,112,78,190,Pt,7.946581999999999,pt190
2391,111,79,190,Au,7.919085999999999,au190
2392,110,80,190,Hg,7.907016,hg190
2393,109,81,190,Tl,7.86586,tl190
2394,108,82,190,Pb,7.84113,pb190
2395,107,83,190,Bi,7.786939,bi190
2396,106,84,190,Po,7.749454000000001,po190
2398,116,75,191,Re,7.943949000000001,re191
2399,115,76,191,Os,7.95056,os191
2400,114,77,191,Ir,7.948100999999999,ir191
2401,113,78,191,Pt,7.938725000000001,pt191
2402,112,79,191,Au,7.924741,au191
2403,111,80,191,Hg,7.903805,hg191
2404,110,81,191,Tl,7.877134,tl191
2405,109,82,191,Pb,7.841441,pb191
2406,108,83,191,Bi,7.800665,bi191
2407,107,84,191,Po,7.7537080000000005,po191
2410,116,76,192,Os,7.948516,os192
2411,115,77,192,Ir,7.938986,ir192
2412,114,78,192,Pt,7.942514,pt192
2413,113,79,192,Au,7.920125,au192
2414,112,80,192,Hg,7.912064999999999,hg192
2415,111,81,192,Tl,7.876016,tl192
2416,110,82,192,Pb,7.8546689999999995,pb192
2417,109,83,192,Bi,7.803666,bi192
2418,108,84,192,Po,7.771078,po192
2420,117,76,193,Os,7.936260999999999,os193
2421,116,77,193,Ir,7.938121,ir193
2422,115,78,193,Pt,7.933773,pt193
2423,114,79,193,Au,7.92411,au193
2424,113,80,193,Hg,7.907914000000001,hg193
2425,112,81,193,Tl,7.884523,tl193
2426,111,82,193,Pb,7.853918,pb193
2427,110,83,193,Bi,7.81711,bi193
2428,109,84,193,Po,7.774129,po193
2429,108,85,193,At,7.727518,at193
2431,118,76,194,Os,7.93201,os194
2432,117,77,194,Ir,7.928475000000001,ir194
2433,116,78,194,Pt,7.935956999999999,pt194
2434,115,79,194,Au,7.919032,au194
2435,114,80,194,Hg,7.914643,hg194
2436,113,81,194,Tl,7.882951,tl194
2437,112,82,194,Pb,7.865416,pb194
2438,111,83,194,Bi,7.819025,bi194
2439,110,84,194,Po,7.789295999999999,po194
2440,109,85,194,At,7.7346580000000005,at194
2441,119,76,195,Os,7.918658000000001,os195
2442,118,77,195,Ir,7.9249019999999994,ir195
2443,117,78,195,Pt,7.9265669999999995,pt195
2444,116,79,195,Au,7.921392,au195
2445,115,80,195,Hg,7.9093290000000005,hg195
2446,114,81,195,Tl,7.890727,tl195
2447,113,82,195,Pb,7.8639399999999995,pb195
2448,112,83,195,Bi,7.830748000000001,bi195
2449,111,84,195,Po,7.7911,po195
2450,110,85,195,At,7.748121,at195
2451,109,86,195,Rn,7.700307,rn195
2452,120,76,196,Os,7.912248000000001,os196
2453,119,77,196,Ir,7.914163,ir196
2454,118,78,196,Pt,7.926544,pt196
2455,117,79,196,Au,7.914861,au196
2456,116,80,196,Hg,7.914373,hg196
2457,115,81,196,Tl,7.888289,tl196
2458,114,82,196,Pb,7.873399999999999,pb196
2459,113,83,196,Bi,7.831899999999999,bi196
2460,112,84,196,Po,7.804773,po196
2461,111,85,196,At,7.752051,at196
2462,110,86,196,Rn,7.7179899999999995,rn196
2463,120,77,197,Ir,7.909018,ir197
2464,119,78,197,Pt,7.915984000000001,pt197
2465,118,79,197,Au,7.915661,au197
2466,117,80,197,Hg,7.908643,hg197
2467,116,81,197,Tl,7.893505,tl197
2468,115,82,197,Pb,7.871298,pb197
2469,114,83,197,Bi,7.841635999999999,bi197
2470,113,84,197,Po,7.805535,po197
2471,112,85,197,At,7.76596,at197
2472,111,86,197,Rn,7.722294,rn197
2474,120,78,198,Pt,7.914169,pt198
2475,119,79,198,Au,7.9085730000000005,au198
2476,118,80,198,Hg,7.9115530000000005,hg198
2477,117,81,198,Tl,7.890127,tl198
2478,116,82,198,Pb,7.878882,pb198
2479,115,83,198,Bi,7.841189,bi198
2480,114,84,198,Po,7.8175609999999995,po198
2481,113,85,198,At,7.769159,at198
2482,112,86,198,Rn,7.737725999999999,rn198
2483,122,77,199,Ir,7.891218000000001,ir199
2484,121,78,199,Pt,7.902319,pt199
2485,120,79,199,Au,7.906943,au199
2486,119,80,199,Hg,7.905284000000001,hg199
2487,118,81,199,Tl,7.893876000000001,tl199
2488,117,82,199,Pb,7.875717,pb199
2489,116,83,199,Bi,7.849526,bi199
2490,115,84,199,Po,7.817537,po199
2491,114,85,199,At,7.781465999999999,at199
2492,113,86,199,Rn,7.7408459999999994,rn199
2493,112,87,199,Fr,7.6953119999999995,fr199
2494,122,78,200,Pt,7.899215999999999,pt200
2495,121,79,200,Au,7.8986350000000005,au200
2496,120,80,200,Hg,7.905899000000001,hg200
2497,119,81,200,Tl,7.889707,tl200
2498,118,82,200,Pb,7.881771,pb200
2499,117,83,200,Bi,7.8484940000000005,bi200
2500,116,84,200,Po,7.827504,po200
2501,115,85,200,At,7.783758000000001,at200
2502,114,86,200,Rn,7.754938,rn200
2503,113,87,200,Fr,7.700385,fr200
2504,123,78,201,Pt,7.885835,pt201
2505,122,79,201,Au,7.895175999999999,au201
2506,121,80,201,Hg,7.897564,hg201
2507,120,81,201,Tl,7.891276999999999,tl201
2508,119,82,201,Pb,7.877812,pb201
2509,118,83,201,Bi,7.854806,bi201
2510,117,84,201,Po,7.82658,po201
2511,116,85,201,At,7.7941530000000006,at201
2512,115,86,201,Rn,7.756841,rn201
2513,114,87,201,Fr,7.714797,fr201
2515,123,79,202,Au,7.88614,au202
2516,122,80,202,Hg,7.896852,hg202
2517,121,81,202,Tl,7.886234,tl202
2518,120,82,202,Pb,7.882115,pb202
2519,119,83,202,Bi,7.852496,bi202
2520,118,84,202,Po,7.834719,po202
2521,117,85,202,At,7.794542,at202
2522,116,86,202,Rn,7.769303000000001,rn202
2523,115,87,202,Fr,7.718812,fr202
2524,114,88,202,Ra,7.684883000000001,ra202
2525,124,79,203,Au,7.880864000000001,au203
2526,123,80,203,Hg,7.887482,hg203
2527,122,81,203,Tl,7.886051999999999,tl203
2528,121,82,203,Pb,7.877397,pb203
2529,120,83,203,Bi,7.857549,bi203
2530,119,84,203,Po,7.832844,po203
2531,118,85,203,At,7.803651999999999,at203
2532,117,86,203,Rn,7.770226,rn203
2533,116,87,203,Fr,7.731783,fr203
2534,115,88,203,Ra,7.689628000000001,ra203
2536,124,80,204,Hg,7.8855450000000005,hg204
2537,123,81,204,Tl,7.880022,tl204
2538,122,82,204,Pb,7.879931,pb204
2539,121,83,204,Bi,7.8543199999999995,bi204
2540,120,84,204,Po,7.8390450000000005,po204
2541,119,85,204,At,7.803552,at204
2542,118,86,204,Rn,7.780641999999999,rn204
2543,117,87,204,Fr,7.734687,fr204
2544,116,88,204,Ra,7.704156,ra204
2546,125,80,205,Hg,7.874731,hg205
2547,124,81,205,Tl,7.878393,tl205
2548,123,82,205,Pb,7.87433,pb205
2549,122,83,205,Bi,7.857302,bi205
2550,121,84,205,Po,7.836156,po205
2551,120,85,205,At,7.810205,at205
2552,119,86,205,Rn,7.780741999999999,rn205
2553,118,87,205,Fr,7.745686,fr205
2554,117,88,205,Ra,7.706996999999999,ra205
2555,126,80,206,Hg,7.86917,hg206
2556,125,81,206,Tl,7.87172,tl206
2557,124,82,206,Pb,7.875361,pb206
2558,123,83,206,Bi,7.8533230000000005,bi206
2559,122,84,206,Po,7.840563,po206
2560,121,85,206,At,7.8087930000000005,at206
2561,120,86,206,Rn,7.788956,rn206
2562,119,87,206,Fr,7.7469399999999995,fr206
2563,118,88,206,Ra,7.719805,ra206
2564,117,89,206,Ac,7.667724,ac206
2565,127,80,207,Hg,7.847312,hg207
2566,126,81,207,Tl,7.866793,tl207
2567,125,82,207,Pb,7.869865,pb207
2568,124,83,207,Bi,7.8545039999999995,bi207
2569,123,84,207,Po,7.836673000000001,po207
2570,122,85,207,At,7.814036999999999,at207
2571,121,86,207,Rn,7.787979999999999,rn207
2572,120,87,207,Fr,7.756232,fr207
2573,119,88,207,Ra,7.721634,ra207
2574,118,89,207,Ac,7.681171999999999,ac207
2576,127,81,208,Tl,7.847180000000001,tl208
2577,126,82,208,Pb,7.867451999999999,pb208
2578,125,83,208,Bi,7.849852,bi208
2579,124,84,208,Po,7.839357,po208
2580,123,85,208,At,7.811663,at208
2581,122,86,208,Rn,7.794231,rn208
2582,121,87,208,Fr,7.756899000000001,fr208
2583,120,88,208,Ra,7.7320839999999995,ra208
2584,119,89,208,Ac,7.684831,ac208
2586,128,81,209,Tl,7.833365,tl209
2587,127,82,209,Pb,7.848647,pb209
2588,126,83,209,Bi,7.8479849999999995,bi209
2589,125,84,209,Po,7.8351869999999995,po209
2590,124,85,209,At,7.814763000000001,at209
2591,123,86,209,Rn,7.792115,rn209
2592,122,87,209,Fr,7.763686,fr209
2593,121,88,209,Ra,7.733033000000001,ra209
2594,120,89,209,Ac,7.695847,ac209
2595,119,90,209,Th,7.655464,th209
2597,129,81,210,Tl,7.813585,tl210
2598,128,82,210,Pb,7.835964,pb210
2599,127,83,210,Bi,7.832541,bi210
2600,126,84,210,Po,7.834345,po210
2601,125,85,210,At,7.811661999999999,at210
2602,124,86,210,Rn,7.796632,rn210
2603,123,87,210,Fr,7.763135999999999,fr210
2604,122,88,210,Ra,7.741281,ra210
2605,121,89,210,Ac,7.697896,ac210
2606,120,90,210,Th,7.669156,th210
2608,129,82,211,Pb,7.817,pb211
2609,128,83,211,Bi,7.81977,bi211
2610,127,84,211,Po,7.818783000000001,po211
2611,126,85,211,At,7.811354000000001,at211
2612,125,86,211,Rn,7.793941,rn211
2613,124,87,211,Fr,7.768443,fr211
2614,123,88,211,Ra,7.741066,ra211
2615,122,89,211,Ac,7.707176,ac211
2616,121,90,211,Th,7.671710999999999,th211
2618,130,82,212,Pb,7.8043119999999995,pb212
2619,129,83,212,Bi,7.803310000000001,bi212
2620,128,84,212,Po,7.810243000000001,po212
2621,127,85,212,At,7.798305999999999,at212
2622,126,86,212,Rn,7.794797,rn212
2623,125,87,212,Fr,7.766946,fr212
2624,124,88,212,Ra,7.747472,ra212
2625,123,89,212,Ac,7.708545999999999,ac212
2626,122,90,212,Th,7.682156,th212
2627,121,91,212,Pa,7.633543,pa212
2628,131,82,213,Pb,7.785081999999999,pb213
2629,130,83,213,Bi,7.791016,bi213
2630,129,84,213,Po,7.794023,po213
2631,128,85,213,At,7.7900030000000005,at213
2632,127,86,213,Rn,7.782191999999999,rn213
2633,126,87,213,Fr,7.768433000000001,fr213
2634,125,88,213,Ra,7.746415,ra213
2635,124,89,213,Ac,7.715524,ac213
2636,123,90,213,Th,7.683852,th213
2637,122,91,213,Pa,7.64476,pa213
2638,132,82,214,Pb,7.772385999999999,pb214
2639,131,83,214,Bi,7.773491999999999,bi214
2640,130,84,214,Po,7.785114999999999,po214
2641,129,85,214,At,7.776365,at214
2642,128,86,214,Rn,7.777102,rn214
2643,127,87,214,Fr,7.757739000000001,fr214
2644,126,88,214,Ra,7.749135,ra214
2645,125,89,214,Ac,7.715907,ac214
2646,124,90,214,Th,7.6922369999999995,th214
2647,123,91,214,Pa,7.647584,pa214
2649,132,83,215,Bi,7.761627,bi215
2650,131,84,215,Po,7.768168999999999,po215
2651,130,85,215,At,7.767855,at215
2652,129,86,215,Rn,7.763814,rn215
2653,128,87,215,Fr,7.75326,fr215
2654,127,88,215,Ra,7.739316999999999,ra215
2655,126,89,215,Ac,7.719501,ac215
2656,125,90,215,Th,7.693001000000001,th215
2657,124,91,215,Pa,7.657061,pa215
2658,133,83,216,Bi,7.743499,bi216
2659,132,84,216,Po,7.758813,po216
2660,131,85,216,At,7.752999,at216
2661,130,86,216,Rn,7.758644,rn216
2662,129,87,216,Fr,7.742414000000001,fr216
2663,128,88,216,Ra,7.737347,ra216
2664,127,89,216,Ac,7.711355999999999,ac216
2665,126,90,216,Th,7.697634,th216
2666,125,91,216,Pa,7.659308000000001,pa216
2668,133,84,217,Po,7.741281,po217
2669,132,85,217,At,7.744611999999999,at217
2670,131,86,217,Rn,7.744403,rn217
2671,130,87,217,Fr,7.737774,fr217
2672,129,88,217,Ra,7.726920999999999,ra217
2673,128,89,217,Ac,7.710324000000001,ac217
2674,127,90,217,Th,7.690547,th217
2675,126,91,217,Pa,7.664579000000001,pa217
2676,125,92,217,U,7.635026,u217
2678,134,84,218,Po,7.731521,po218
2679,133,85,218,At,7.729124,at218
2680,132,86,218,Rn,7.738751000000001,rn218
2681,131,87,218,Fr,7.726715,fr218
2682,130,88,218,Ra,7.724998,ra218
2683,129,89,218,Ac,7.702176,ac218
2684,128,90,218,Th,7.691566999999999,th218
2685,127,91,218,Pa,7.659104,pa218
2686,126,92,218,U,7.640586999999999,u218
2688,134,85,219,At,7.720191,at219
2689,133,86,219,Rn,7.723771,rn219
2690,132,87,219,Fr,7.721169,fr219
2691,131,88,219,Ra,7.714054,ra219
2692,130,89,219,Ac,7.700548,ac219
2693,129,90,219,Th,7.68372,th219
2694,128,91,219,Pa,7.661662,pa219
2695,127,92,219,U,7.6366689999999995,u219
2697,135,85,220,At,7.703810000000001,at220
2698,134,86,220,Rn,7.7172480000000006,rn220
2699,133,87,220,Fr,7.70974,fr220
2700,132,88,220,Ra,7.711684,ra220
2701,131,89,220,Ac,7.692315,ac220
2702,130,90,220,Th,7.684589,th220
2703,129,91,220,Pa,7.655089,pa220
2706,135,86,221,Rn,7.701388000000001,rn221
2707,134,87,221,Fr,7.703251999999999,fr221
2708,133,88,221,Ra,7.701134,ra221
2709,132,89,221,Ac,7.690539,ac221
2710,131,90,221,Th,7.676072,th221
2711,130,91,221,Pa,7.656960999999999,pa221
2714,136,86,222,Rn,7.694491,rn222
2715,135,87,222,Fr,7.691076,fr222
2716,134,88,222,Ra,7.696687,ra222
2717,133,89,222,Ac,7.682802,ac222
2718,132,90,222,Th,7.676659000000001,th222
2723,136,87,223,Fr,7.683658,fr223
2724,135,88,223,Ra,7.685303000000001,ra223
2725,134,89,223,Ac,7.6791409999999996,ac223
2726,133,90,223,Th,7.66864,th223
2727,132,91,223,Pa,7.651971,pa223
2728,131,92,223,U,7.632688,u223
2730,137,87,224,Fr,7.670775,fr224
2731,136,88,224,Ra,7.679917,ra224
2732,135,89,224,Ac,7.67014,ac224
2733,134,90,224,Th,7.667712,th224
2734,133,91,224,Pa,7.646925,pa224
2735,132,92,224,U,7.635203000000001,u224
2737,138,87,225,Fr,7.6629700000000005,fr225
2738,137,88,225,Ra,7.667581,ra225
2739,136,89,225,Ac,7.665686,ac225
2740,135,90,225,Th,7.659222,th225
2741,134,91,225,Pa,7.646720999999999,pa225
2742,133,92,225,U,7.629746999999999,u225
2743,132,93,225,Np,7.607544,np225
2745,139,87,226,Fr,7.649028,fr226
2746,138,88,226,Ra,7.661956,ra226
2747,137,89,226,Ac,7.655658000000001,ac226
2748,136,90,226,Th,7.657121,th226
2749,135,91,226,Pa,7.641109999999999,pa226
2750,134,92,226,U,7.631916,u226
2753,140,87,227,Fr,7.640835999999999,fr227
2754,139,88,227,Ra,7.6482969999999995,ra227
2755,138,89,227,Ac,7.650701,ac227
2756,137,90,227,Th,7.6474519999999995,th227
2757,136,91,227,Pa,7.639488,pa227
2758,135,92,227,U,7.626393,u227
2759,134,93,227,Np,7.6073509999999995,np227
2762,140,88,228,Ra,7.642421,ra228
2763,139,89,228,Ac,7.639190999999999,ac228
2764,138,90,228,Th,7.645074,th228
2765,137,91,228,Pa,7.632204000000001,pa228
2766,136,92,228,U,7.627455,u228
2768,134,94,228,Pu,7.590489000000001,pu228
2769,142,87,229,Fr,7.617691,fr229
2770,141,88,229,Ra,7.628482,ra229
2771,140,89,229,Ac,7.632966,ac229
2772,139,90,229,Th,7.634646,th229
2773,138,91,229,Pa,7.629869,pa229
2774,137,92,229,U,7.620721,u229
2775,136,93,229,Np,7.606087,np229
2776,135,94,229,Pu,7.586861999999999,pu229
2778,142,88,230,Ra,7.621906999999999,ra230
2779,141,89,230,Ac,7.621593000000001,ac230
2780,140,90,230,Th,7.63099,th230
2781,139,91,230,Pa,7.621891,pa230
2782,138,92,230,U,7.620923,u230
2783,137,93,230,Np,7.601776,np230
2784,136,94,230,Pu,7.590994,pu230
2787,142,89,231,Ac,7.614406999999999,ac231
2788,141,90,231,Th,7.620111999999999,th231
2789,140,91,231,Pa,7.61842,pa231
2790,139,92,231,U,7.6133809999999995,u231
2791,138,93,231,Np,7.602125,np231
2792,137,94,231,Pu,7.587222,pu231
2796,143,89,232,Ac,7.60245,ac232
2797,142,90,232,Th,7.615025999999999,th232
2798,141,91,232,Pa,7.609501,pa232
2799,140,92,232,U,7.611892,u232
2801,138,94,232,Pu,7.588963000000001,pu232
2805,143,90,233,Th,7.602886,th233
2806,142,91,233,Pa,7.604864,pa233
2807,141,92,233,U,7.603953000000001,u233
2808,140,93,233,Np,7.596176,np233
2809,139,94,233,Pu,7.5837959999999995,pu233
2811,137,96,233,Cm,7.546002,cm233
2814,144,90,234,Th,7.596849,th234
2815,143,91,234,Pa,7.594673000000001,pa234
2816,142,92,234,U,7.600708000000001,u234
2817,141,93,234,Np,7.5896300000000005,np234
2818,140,94,234,Pu,7.584607,pu234
2820,138,96,234,Cm,7.550681,cm234
2822,145,90,235,Th,7.583374,th235
2823,144,91,235,Pa,7.588236,pa235
2824,143,92,235,U,7.590907,u235
2825,142,93,235,Np,7.587049,np235
2826,141,94,235,Pu,7.578873000000001,pu235
2832,145,91,236,Pa,7.577504,pa236
2833,144,92,236,U,7.5864769999999995,u236
2834,143,93,236,Np,7.579209,np236
2835,142,94,236,Pu,7.577913000000001,pu236
2840,146,91,237,Pa,7.569901999999999,pa237
2841,145,92,237,U,7.576094,u237
2842,144,93,237,Np,7.574982,np237
2843,143,94,237,Pu,7.570752,pu237
2849,147,91,238,Pa,7.55887,pa238
2850,146,92,238,U,7.57012,u238
2851,145,93,238,Np,7.5662139999999996,np238
2852,144,94,238,Pu,7.568354,pu238
2853,143,95,238,Am,7.555578000000001,am238
2854,142,96,238,Cm,7.548203,cm238
2858,147,92,239,U,7.5585569999999995,u239
2859,146,93,239,Np,7.560561,np239
2860,145,94,239,Pu,7.560311,pu239
2861,144,95,239,Am,7.553680999999999,am239
2866,148,92,240,U,7.551771,u240
2867,147,93,240,Np,7.55018,np240
2868,146,94,240,Pu,7.556036,pu240
2869,145,95,240,Am,7.547006,am240
2870,144,96,240,Cm,7.542856,cm240
2875,148,93,241,Np,7.544263000000001,np241
2876,147,94,241,Pu,7.546431999999999,pu241
2877,146,95,241,Am,7.543272,am241
2878,145,96,241,Cm,7.536840999999999,cm241
2883,149,93,242,Np,7.533397,np242
2884,148,94,242,Pu,7.541321,pu242
2885,147,95,242,Am,7.534984000000001,am242
2886,146,96,242,Cm,7.534496999999999,cm242
2888,144,98,242,Cf,7.509302,cf242
2892,149,94,243,Pu,7.531004,pu243
2893,148,95,243,Am,7.530169,am243
2894,147,96,243,Cm,7.526918,cm243
2895,146,97,243,Bk,7.517495,bk243
2900,150,94,244,Pu,7.524816999999999,pu244
2901,149,95,244,Am,7.521300999999999,am244
2902,148,96,244,Cm,7.523944,cm244
2903,147,97,244,Bk,7.511468000000001,bk244
2904,146,98,244,Cf,7.505132,cf244
2907,151,94,245,Pu,7.513576,pu245
2908,150,95,245,Am,7.515306,am245
2909,149,96,245,Cm,7.515765999999999,cm245
2910,148,97,245,Bk,7.509264,bk245
2911,147,98,245,Cf,7.499656999999999,cf245
2915,152,94,246,Pu,7.506538000000001,pu246
2916,151,95,246,Am,7.504986,am246
2917,150,96,246,Cm,7.511465,cm246
2918,149,97,246,Bk,7.502796999999999,bk246
2919,148,98,246,Cf,7.499115,cf246
2921,146,100,246,Fm,7.468166,fm246
2925,151,96,247,Cm,7.501928,cm247
2926,150,97,247,Bk,7.498936,bk247
2927,149,98,247,Cf,7.493153,cf247
2932,152,96,248,Cm,7.496731,cm248
2934,150,98,248,Cf,7.491036,cf248
2936,148,100,248,Fm,7.46591,fm248
2940,153,96,249,Cm,7.485551999999999,cm249
2941,152,97,249,Bk,7.486026999999999,bk249
2942,151,98,249,Cf,7.483383000000001,cf249
2947,154,96,250,Cm,7.47894,cm250
2948,153,97,250,Bk,7.475960999999999,bk250
2949,152,98,250,Cf,7.47995,cf250
2951,150,100,250,Fm,7.462084,fm250
2954,155,96,251,Cm,7.466724,cm251
2955,154,97,251,Bk,7.469264,bk251
2956,153,98,251,Cf,7.470502,cf251
2957,152,99,251,Es,7.4658809999999995,es251
2958,151,100,251,Fm,7.4568900000000005,fm251
2964,154,98,252,Cf,7.465349,cf252
2965,153,99,252,Es,7.457244,es252
2966,152,100,252,Fm,7.456031,fm252
2968,150,102,252,No,7.42576,no252
2971,155,98,253,Cf,7.454831,cf253
2972,154,99,253,Es,7.4528739999999996,es253
2973,153,100,253,Fm,7.448455,fm253
2979,156,98,254,Cf,7.449228,cf254
2980,155,99,254,Es,7.4435839999999995,es254
2981,154,100,254,Fm,7.444786,fm254
2983,152,102,254,No,7.423585999999999,no254
2987,156,99,255,Es,7.437821999999999,es255
2988,155,100,255,Fm,7.4358900000000006,fm255
2989,154,101,255,Md,7.428729000000001,md255
2990,153,102,255,No,7.417776,no255
2996,156,100,256,Fm,7.431783,fm256
2997,155,101,256,Md,7.420409,md256
2998,154,102,256,No,7.416539000000001,no256
3000,152,104,256,Rf,7.385381,rf256
3003,157,100,257,Fm,7.422196,fm257
3004,156,101,257,Md,7.417569,md257
3005,155,102,257,No,7.409683000000001,no257
3011,157,101,258,Md,7.409669,md258
3030,154,106,260,Sg,7.342424,sg260
3035,157,104,261,Rf,7.371396,rf261
3059,156,108,264,Hs,7.298239000000001,hs264
3063,159,106,265,Sg,7.3326519999999995,sg265
3064,11,18,29,Ar,6.11157,ar29
3065,12,18,30,Ar,6.886,ar30
3066,13,18,31,Ar,7.253,ar31
3067,30,18,48,Ar,8.245,ar48
3068,31,18,49,Ar,8.128,ar49
3069,32,18,50,Ar,8.048,ar50
3070,33,18,51,Ar,7.91,ar51
3071,34,18,52,Ar,7.819,ar52
3072,35,18,53,Ar,7.677,ar53
3073,36,18,54,Ar,7.71070,ar54
3074,15,6,21,C,,c21
3074,16,6,22,C,,c22
